Player,height,weight,collage,born,G,MP,FG,FGA,FT,FTA,3P,3PA,2P,2PA,ORB,DRB,TRB,AST,STL,BLK,TOV,PF,PTS
A.C. Green,203,106,NaN,1960,1361,39044,4778,9686,3247,4447,125,509,4653,9177,3576,6553,10129,1469,1103,562,1508,2581,12928
A.J. Bramlett,196,88,NaN,1973,8,61,4,21,0,0,0,0,4,21,12,10,22,0,1,0,3,13,8
A.J. English,196,95,NaN,1963,151,3108,617,1418,259,333,9,65,608,1353,140,175,315,320,57,24,203,287,1502
A.J. Guyton,208,99,NaN,1976,80,1246,166,440,37,45,73,193,93,247,22,58,80,147,20,12,62,58,442
A.J. Hammons,198,99,NaN,1993,22,163,17,42,9,20,5,10,12,32,8,28,36,4,1,13,10,21,48
A.J. Price,213,124,NaN,1989,287,4253,600,1581,223,303,233,747,367,834,74,335,409,613,132,9,243,252,1656
A.J. Wynder,190,83,NaN,1947,6,39,3,12,6,8,0,1,3,11,1,2,3,8,1,0,4,1,12
Aaron Brooks,183,73,University of Oregon,1985,797,17088,2829,6893,1156,1371,1025,2805,1804,4088,323,1037,1360,2485,469,113,1272,1544,7839
Aaron Gordon,206,99,University of Arizona,1995,205,4958,760,1652,329,471,132,457,628,1195,316,765,1081,311,144,117,193,408,1981
Aaron Gray,213,122,University of Pittsburgh,1984,387,4517,509,1007,217,379,0,4,509,1003,518,889,1407,251,113,106,314,796,1235
Aaron Harrison,198,95,University of Kentucky,1994,26,110,5,23,6,14,3,12,2,11,4,14,18,5,6,0,4,12,19
Aaron McKie,196,94,Temple University,1972,957,22594,2554,5923,1087,1389,441,1275,2113,4648,580,2459,3039,2462,1090,199,1225,1882,6636
Aaron Miles,185,79,University of Kansas,1983,19,118,6,18,4,4,0,0,6,18,0,14,14,24,4,1,11,13,16
Aaron Swinson,196,104,Auburn University,1971,9,51,10,18,4,5,0,0,10,18,3,5,8,3,1,0,5,8,24
Aaron Williams,206,99,Xavier University,1971,838,13669,1777,3577,1063,1442,1,17,1776,3560,1159,2015,3174,525,320,597,742,2030,4618
Acie Earl,208,108,University of Iowa,1970,240,3012,428,1076,312,471,0,14,428,1062,225,388,613,81,78,154,205,412,1168
Acie Law,190,88,Texas A&M University,1985,265,3345,379,898,257,334,38,167,341,731,48,227,275,419,126,5,205,270,1053
Adam Harrington,196,90,Auburn University,1980,38,222,22,74,6,8,10,28,12,46,2,14,16,24,4,2,4,16,60
Adam Keefe,206,104,Stanford University,1970,617,10334,1120,2230,866,1213,1,14,1119,2216,999,1557,2556,427,307,173,545,1114,3107
Adam Morrison,203,92,Gonzaga University,1984,213,3989,547,1475,159,223,156,471,391,1004,100,322,422,263,49,16,204,350,1409
Adonal Foyle,208,113,Colgate University,1975,743,13122,1325,2777,356,713,0,2,1325,2775,1310,2177,3487,345,264,1201,600,1580,3006
Adonis Jordan,180,77,University of Kansas,1970,10,97,8,27,2,4,3,12,5,15,3,3,6,22,3,1,8,6,21
Adonis Thomas,201,90,University of Memphis,1993,12,74,12,28,2,2,2,10,10,18,0,6,6,6,0,0,2,12,28
Adreian Payne,208,107,Michigan State University,1991,134,2099,258,639,91,137,14,65,244,574,125,343,468,96,62,36,132,285,621
Adrian Branch,201,83,University of Maryland,1963,130,1429,331,727,163,219,9,39,322,688,114,139,253,96,83,17,125,193,834
Adrian Caldwell,203,120,Lamar University,1966,242,2172,204,430,83,187,0,5,204,425,238,425,663,45,72,49,154,357,491
Adrian Dantley*,196,94,University of Notre Dame,1956,482,15865,3565,6848,3237,3993,3,26,3562,6822,834,1262,2096,1214,334,62,1125,1155,10370
Adrian Griffin,196,98,Seton Hall University,1974,512,8304,815,1870,304,401,50,180,765,1690,535,1036,1571,680,453,61,352,906,1984
Al Harrington,206,104,NaN,1980,1132,33118,6055,13613,2606,3567,1275,3541,4780,10072,1745,4688,6433,1900,1011,292,2168,3565,15991
Al Horford,208,111,University of Florida,1986,646,21535,3923,7427,1199,1603,195,563,3728,6864,1472,4136,5608,1926,534,784,1031,1537,9240
Al Jefferson,208,131,NaN,1985,879,25815,6050,12136,1983,2797,8,63,6042,12073,2024,5523,7547,1317,612,1070,1190,2281,14091
Al Thornton,203,99,Florida State University,1983,442,11736,1893,4136,976,1307,93,323,1800,3813,564,1176,1740,505,265,199,590,1120,4855
Al Wood,198,87,University of North Carolina,1958,212,4951,991,2188,462,592,19,95,972,2093,218,399,617,384,160,82,261,441,2463
Al-Farouq Aminu,206,99,Wake Forest University,1990,520,12520,1398,3281,665,917,305,942,1093,2339,727,2221,2948,639,494,307,667,967,3766
Alaa Abdelnaby,208,108,Duke University,1968,385,5017,983,1940,333,472,0,6,983,1934,446,851,1297,125,111,107,389,777,2299
Alan Anderson,198,99,Michigan State University,1982,330,6793,843,2084,404,495,331,963,512,1121,151,563,714,371,182,31,290,602,2421
Alan Henderson,206,106,Indiana University,1972,652,13780,1976,4215,1137,1778,5,26,1971,4189,1426,1823,3249,397,364,297,717,1436,5094
Alan Ogg,218,108,University of Alabama at Birmingham,1967,86,686,80,165,28,48,0,2,80,163,51,92,143,17,13,61,33,138,188
Alan Williams,198,90,Drake University,1948,57,776,148,291,79,126,0,1,148,290,108,222,330,28,31,37,43,140,375
Alando Tucker,203,86,Oklahoma Baptist University,1943,66,522,94,221,63,81,11,41,83,180,35,24,59,20,5,2,24,28,262
Albert King,198,86,University of Maryland,1959,300,6592,1271,2891,455,566,44,151,1227,2740,373,733,1106,535,202,86,518,815,3041
Alec Burks,198,97,University of Colorado,1991,301,6618,1053,2458,747,993,181,503,872,1955,205,672,877,534,184,46,412,573,3034
Alec Kessler,211,104,University of Georgia,1967,210,2937,425,998,224,301,10,24,415,974,258,493,751,81,39,71,192,451,1084
Aleksandar Djordjevic,188,89,NaN,1967,8,61,8,16,4,5,5,7,3,9,1,4,5,5,0,0,5,3,25
Aleksandar Radojevic,221,113,Barton County Community College,1976,15,152,8,26,10,16,0,0,8,26,11,25,36,7,2,3,20,37,26
Alex Abrines,198,86,NaN,1993,68,1055,134,341,44,49,94,247,40,94,18,68,86,40,37,8,33,114,406
Alex Acker,196,83,Pepperdine University,1983,55,433,64,168,10,20,15,45,49,123,17,36,53,28,11,8,18,22,153
Alex Blackwell,198,113,Monmouth University,1970,27,109,14,42,6,8,0,3,14,39,10,13,23,7,4,2,5,14,34
Alex English*,201,86,University of South Carolina,1954,565,18800,5579,11232,2224,2623,10,45,5569,11187,1082,1364,2446,2176,474,179,1287,1348,13392
Alex Garcia,190,99,NaN,1980,10,159,19,59,4,6,5,18,14,41,7,8,15,18,6,1,9,15,47
Alex Kirk,213,111,University of New Mexico,1991,5,14,1,4,2,2,0,0,1,4,1,0,1,1,0,0,0,1,4
Alex Len,216,117,University of Maryland,1993,266,5261,706,1518,417,582,5,22,701,1496,515,1142,1657,177,113,283,347,753,1834
Alex Poythress,201,107,University of Kentucky,1993,6,157,25,54,8,10,6,19,19,35,11,18,29,5,3,2,3,14,64
Alex Scales,193,83,University of Oregon,1978,1,0,0,0,0,0,0,0,0,0,0,0,0,0,0,0,0,0,0
Alex Stepheson,208,122,University of Southern California,1987,16,146,18,54,8,24,0,0,18,54,38,18,56,4,2,10,0,24,44
Alex Stivrins,203,99,University of Colorado,1962,41,166,39,82,7,12,0,4,39,78,17,24,41,7,4,4,17,24,85
Alexander Johnson,206,108,Florida State University,1983,102,1302,152,294,135,201,0,0,152,294,82,193,275,30,38,45,89,217,439
Alexander Volkov,208,98,NaN,1964,149,2453,388,853,195,318,48,144,340,709,155,229,384,333,102,52,154,344,1019
Alexey Shved,198,86,NaN,1988,224,4038,578,1542,418,540,209,668,369,874,108,346,454,566,140,55,291,249,1783
Alexis Ajinca,218,112,NaN,1988,327,4245,704,1416,264,333,24,76,680,1340,363,865,1228,153,113,200,267,734,1696
Alfredrick Hughes,198,92,NaN,1960,68,866,152,372,49,84,3,17,149,355,49,64,113,61,26,5,63,79,356
Allan Houston,198,90,University of Tennessee,1971,839,28311,5337,12017,2572,2979,1305,3247,4032,8770,353,2081,2434,1990,566,139,1760,2062,14551
Allan Ray,188,86,Villanova University,1984,47,710,100,259,42,55,48,116,52,143,18,51,69,43,20,3,42,85,290
Allen Crabbe,198,95,University of California,1992,226,5142,689,1511,218,257,282,686,407,825,54,469,523,237,138,52,144,447,1878
Allen Iverson*,183,74,Georgetown University,1975,1064,43303,9532,22369,7235,9256,1158,3704,8374,18665,814,3025,3839,6488,2213,185,3740,2006,27457
Allen Leavell,185,77,Oklahoma City University,1957,304,5678,803,1879,541,645,74,290,729,1589,63,303,366,1092,283,36,395,536,2221
Alonzo Gee,198,102,University of Alabama,1987,527,10851,1209,2759,692,920,216,658,993,2101,488,1148,1636,504,454,126,535,944,3326
Alonzo Mourning*,208,108,Georgetown University,1970,875,26677,5216,9913,4139,6003,22,89,5194,9824,2237,5098,7335,964,422,2430,2266,2892,14593
Alphonso Ford,185,86,Mississippi Valley State University,1971,11,114,16,52,2,4,1,10,15,42,8,12,20,10,3,0,9,7,35
Alton Ford,185,86,Mississippi Valley State University,1971,73,524,70,138,46,66,0,0,70,138,35,89,124,11,6,8,37,115,186
Alton Lister,213,108,Arizona State University,1958,775,14674,1888,3699,1002,1643,1,9,1887,3690,1479,3239,4718,628,248,1080,1030,2421,4779
Alvan Adams,206,95,University of Oklahoma,1954,310,7477,1379,2718,651,784,1,5,1378,2713,510,1170,1680,1038,362,172,682,978,3410
Alvin Heggs,203,102,University of Texas at Austin,1967,4,14,3,5,2,3,0,0,3,5,1,1,2,0,0,0,0,0,8
Alvin Jones,211,120,Georgia Institute of Technology,1978,23,126,8,20,10,20,0,0,8,20,13,23,36,3,3,9,11,35,26
Alvin Robertson,190,83,University of Arkansas,1962,848,26675,4659,9784,1906,2579,276,922,4383,8862,1728,2607,4335,4192,2267,341,2249,2856,11500
Alvin Scott,201,83,Oral Roberts University,1955,77,1238,111,259,53,74,1,5,110,254,46,115,161,127,39,25,60,125,276
Alvin Sims,193,106,University of Louisville,1974,4,25,4,10,2,5,1,1,3,9,3,1,4,5,2,0,6,2,11
Alvin Williams,198,90,Drake University,1948,514,13681,1789,4232,690,912,217,692,1572,3540,276,945,1221,1980,587,112,681,976,4485
Amal McCaskill,211,106,Marquette University,1973,114,968,81,215,42,69,0,3,81,212,75,138,213,36,24,36,52,132,204
Amar'e Stoudemire,208,111,NaN,1982,905,27499,6184,11499,4276,5630,30,131,6154,11368,2139,4822,6961,1095,665,1092,2031,2846,16674
Amir Johnson,206,108,NaN,1987,745,16623,2339,4073,796,1181,85,250,2254,3823,1552,2662,4214,895,464,782,832,2287,5559
Anderson Varejao,208,123,NaN,1982,680,15547,1857,3658,984,1559,1,43,1856,3615,1541,3111,4652,769,553,415,614,1700,4699
Andrae Patterson,206,107,Indiana University,1975,40,304,46,101,28,36,0,5,46,96,31,36,67,16,20,7,23,66,120
Andray Blatche,211,106,NaN,1986,564,12462,2327,4981,1000,1380,52,219,2275,4762,1043,1981,3024,798,492,458,914,1382,5706
Andre Barrett,178,78,Seton Hall University,1982,124,1584,172,469,47,64,33,135,139,334,41,95,136,256,58,2,89,133,424
Andre Brown,206,111,DePaul University,1981,75,598,82,159,33,66,0,1,82,158,70,108,178,11,14,8,48,73,197
Andre Dawkins,196,97,Duke University,1991,4,22,1,6,0,0,1,6,0,0,0,2,2,1,0,0,1,3,3
Andre Drummond,211,126,University of Connecticut,1993,385,11439,2216,4043,683,1793,5,19,2211,4024,1786,3160,4946,276,476,580,594,1184,5120
Andre Emmett,196,104,Texas Tech University,1982,14,73,6,13,8,13,0,1,6,12,2,6,8,1,2,1,3,6,20
Andre Iguodala,198,97,University of Arizona,1984,976,33834,4543,9776,2689,3764,908,2705,3635,7071,941,4192,5133,4396,1548,463,1991,1816,12683
Andre Miller,206,102,Michigan State University,1971,1562,45930,6769,14640,4379,5444,218,986,6551,13654,1547,3934,5481,9717,1738,252,3545,3290,18135
Andre Moore,206,97,Loyola University of Chicago,1964,20,100,18,54,12,16,0,0,18,54,12,16,28,12,4,2,8,12,48
Andre Owens,193,90,University of Houston,1980,54,602,67,181,37,52,21,56,46,125,24,44,68,55,18,3,37,62,192
Andre Roberson,196,83,Oral Roberts University,1955,256,5614,476,1006,110,223,100,385,376,621,273,729,1002,211,219,160,151,552,1162
Andre Spencer,198,95,Northern Arizona University,1964,96,1542,250,562,192,262,0,4,250,558,136,172,308,92,72,28,94,214,692
Andre Turner,180,72,University of Memphis,1964,181,2638,318,765,143,186,14,61,304,704,66,205,271,558,145,3,224,211,793
Andrea Bargnani,213,111,NaN,1985,550,15806,2932,6676,1382,1677,627,1771,2305,4905,530,2011,2541,653,207,470,851,1338,7873
Andreas Glyniadakis,216,127,NaN,1981,13,81,8,17,1,2,0,0,8,17,2,6,8,1,0,0,9,19,17
Andrei Kirilenko,206,99,NaN,1981,797,23916,3146,6637,2772,3675,367,1185,2779,5452,1400,2952,4352,2169,1097,1461,1518,1605,9431
Andres Guibert,208,102,NaN,1968,22,200,22,67,16,25,0,4,22,63,26,35,61,12,8,2,18,35,60
Andres Nocioni,201,102,NaN,1979,590,14004,2231,5179,1109,1389,711,1885,1520,3294,408,2248,2656,716,254,261,837,1655,6282
Andrew Bogut,213,117,University of Utah,1984,698,20095,2989,5605,831,1501,3,26,2986,5579,1772,4425,6197,1569,448,1095,1220,2210,6812
Andrew Bynum,213,129,NaN,1987,444,11206,2011,3671,1024,1480,1,9,2010,3662,1060,2306,3366,519,139,686,678,1059,5047
Andrew DeClercq,208,104,University of Florida,1973,634,10949,1256,2483,674,1073,0,2,1256,2481,1129,1614,2743,370,440,330,604,1950,3186
Andrew Gaze,201,92,Seton Hall University,1965,26,128,16,42,2,2,9,24,7,18,3,9,12,11,4,2,7,16,43
Andrew Goudelock,190,90,College of Charleston,1988,49,475,77,196,14,16,29,84,48,112,7,27,34,24,10,2,28,36,197
Andrew Harrison,198,96,University of Kentucky,1994,72,1474,117,360,148,194,43,156,74,204,23,113,136,198,54,20,85,194,425
Andrew Lang,211,111,University of Arkansas,1966,808,17709,2133,4575,991,1320,6,25,2127,4550,1341,2625,3966,489,374,1225,821,2278,5263
Andrew Nicholson,206,113,St. Bonaventure University,1989,323,4422,751,1628,206,269,92,298,659,1330,203,715,918,136,90,101,229,513,1800
Andrew Toney,190,80,University of Louisiana at Lafayette,1957,157,3901,730,1558,500,602,70,201,660,1357,61,253,314,671,96,38,393,332,2030
Andrew Wiggins,203,90,University of Kansas,1995,245,8862,1800,4001,1196,1573,199,605,1601,3396,342,652,994,523,246,126,546,538,4995
Andris Biedrins,211,108,NaN,1986,516,11146,1432,2409,383,766,0,2,1432,2407,1190,2441,3631,467,331,580,479,1626,3247
Andy Panko,206,100,Lebanon Valley College,1977,1,1,0,0,0,0,0,0,0,0,0,0,0,0,0,0,0,0,0
Andy Rautins,193,86,Syracuse University,1986,5,24,3,7,1,2,1,4,2,3,0,1,1,3,1,0,7,0,8
Andy Toolson,198,95,Brigham Young University,1966,60,523,58,146,28,37,15,44,43,102,32,41,73,32,14,2,26,70,159
Anfernee Hardaway,201,88,University of Memphis,1971,780,25806,4274,9410,2302,2969,533,1670,3741,7740,1044,2389,3433,3701,1195,332,1893,1708,11383
Ansu Sesay,206,102,University of Mississippi,1976,127,1301,161,371,71,111,8,29,153,342,102,121,223,62,38,30,58,162,401
Antawn Jamison,203,101,University of North Carolina,1976,1149,40044,8157,18060,3715,5160,1248,3612,6909,14448,2693,6019,8712,1845,1119,442,1805,2759,21277
Anthony Avent,206,106,Seton Hall University,1969,426,8100,964,2417,419,604,0,2,964,2415,704,1218,1922,343,199,242,501,971,2347
Anthony Bennett,203,111,"University of Nevada, Las Vegas",1993,151,1905,251,641,120,179,36,138,215,503,132,340,472,77,58,27,99,206,658
Anthony Bonner,203,97,Saint Louis University,1968,318,7372,881,1881,435,737,2,16,879,1865,708,1018,1726,442,346,84,450,784,2199
Anthony Bowie,198,86,University of Oklahoma,1963,461,8349,1247,2628,384,466,67,211,1180,2417,299,722,1021,840,288,106,478,711,2945
Anthony Brown,206,111,DePaul University,1981,51,917,75,226,17,20,34,124,41,102,25,111,136,35,24,7,27,64,201
Anthony Carter,185,86,University of Hawaii,1975,656,12647,1275,3149,441,621,128,504,1147,2645,251,1102,1353,2432,628,121,997,1152,3119
Anthony Cook,206,92,University of Arizona,1967,141,1702,192,432,96,189,0,7,192,425,192,292,484,38,46,105,78,162,480
Anthony Davis,206,97,University of Texas at El Paso,1968,335,11531,2843,5543,1733,2203,78,269,2765,5274,849,2555,3404,590,436,793,595,815,7497
Anthony Frederick,201,92,Pepperdine University,1964,147,1640,291,663,130,186,6,22,285,641,137,143,280,135,76,45,132,200,718
Anthony Goldwire,185,82,University of Houston,1971,385,6846,784,1938,393,497,307,783,477,1155,95,420,515,1049,223,11,364,535,2268
Anthony Grundy,190,81,North Carolina State University,1979,12,108,19,38,9,14,5,15,14,23,1,16,17,9,7,0,9,14,52
Anthony Johnson,196,97,University of Portland,1932,1038,19532,2121,5145,814,1092,402,1115,1719,4030,368,1323,1691,2887,692,114,1092,1643,5458
Anthony Jones,198,88,"University of Nevada, Las Vegas",1962,262,2758,396,996,175,231,26,85,370,911,141,205,346,209,138,60,150,275,993
Anthony Mason,201,113,Tennessee State University,1966,882,30605,3583,7033,2488,3511,2,12,3581,7021,1912,5367,7279,2963,648,244,1549,2353,9656
Anthony Miller,206,102,Michigan State University,1971,185,1648,198,388,114,198,2,8,196,380,185,305,490,66,58,26,91,245,512
Anthony Morrow,196,95,Georgia Institute of Technology,1985,654,13377,2118,4777,662,750,864,2113,1254,2664,332,944,1276,532,354,78,394,984,5762
Anthony Parker,198,97,Bradley University,1975,494,13752,1661,3744,560,705,596,1474,1065,2270,241,1333,1574,1129,439,85,495,792,4478
Anthony Peeler,193,94,University of Missouri,1969,865,21657,3291,7675,911,1142,993,2570,2298,5105,601,1658,2259,2093,836,144,1070,1767,8486
Anthony Pullard,208,111,McNeese State University,1966,8,37,8,18,1,3,0,0,8,18,2,6,8,2,2,2,5,5,17
Anthony Randolph,208,92,Louisiana State University,1989,292,4431,800,1758,473,647,21,87,779,1671,378,860,1238,220,172,248,351,518,2094
Anthony Roberson,196,83,Oral Roberts University,1955,94,867,146,375,14,15,78,227,68,148,14,57,71,55,33,2,32,69,384
Anthony Taylor,193,79,University of Oregon,1965,21,368,60,151,24,32,0,2,60,149,11,23,34,43,22,5,20,37,144
Anthony Tolliver,203,108,Creighton University,1985,642,13249,1433,3450,632,823,728,2023,705,1427,578,1814,2392,616,256,209,428,1120,4226
Anthony Tucker,203,99,Wake Forest University,1969,62,982,96,210,51,83,0,1,96,209,44,126,170,68,46,11,56,129,243
Antoine Carr,206,102,Wichita State University,1961,1064,21507,4019,8007,2081,2662,6,53,4013,7954,1266,2440,3706,1205,391,993,1312,3310,10125
Antoine Rigaudeau,201,95,NaN,1971,11,91,8,35,0,0,1,5,7,30,4,4,8,6,3,0,6,11,17
Antoine Walker,193,86,Niagara University,1955,970,34486,6666,16087,2292,3676,1496,4605,5170,11482,2076,5510,7586,3435,1174,527,2757,2733,17120
Antoine Wright,201,95,Texas A&M University,1984,353,6946,753,1828,271,401,187,620,566,1208,197,631,828,375,167,93,277,725,1964
Antonio Anderson,188,83,Canisius College,1945,1,15,1,3,0,0,0,0,1,3,1,0,1,0,0,0,1,1,2
Antonio Burks,185,90,University of Memphis,1980,81,789,79,204,24,42,4,17,75,187,5,44,49,104,33,1,48,70,186
Antonio Daniels,193,88,Bowling Green State University,1975,946,20692,2369,5345,1804,2273,381,1214,1988,4131,224,1466,1690,3111,590,86,990,972,6923
Antonio Davis,206,97,University of Texas at El Paso,1968,1027,29594,3535,7970,2893,3979,2,24,3533,7946,2620,5014,7634,1175,490,964,1511,2882,9965
Antonio Harvey,211,102,Pfeiffer University,1970,242,2775,313,789,130,263,1,5,312,784,224,409,633,73,81,177,152,331,757
Antonio Lang,211,111,University of Arkansas,1966,153,1433,122,272,91,126,0,8,122,264,80,135,215,52,59,47,91,215,335
Antonio McDyess,206,99,University of Alabama,1974,1057,28980,5172,10429,2166,3247,7,60,5165,10369,2548,5347,7895,1336,819,1126,1680,3194,12517
Antonis Fotsis,208,99,NaN,1981,28,320,42,104,17,20,7,23,35,81,25,37,62,10,9,11,21,22,108
Archie Goodwin,196,90,University of Kentucky,1994,180,2610,403,922,294,415,50,206,353,716,93,266,359,230,73,43,220,200,1150
Arinze Onuaku,206,115,Syracuse University,1987,24,156,16,28,5,12,0,0,16,28,13,30,43,12,1,4,6,15,37
Armen Gilliam,206,104,"University of Nevada, Las Vegas",1964,1080,31491,5809,11836,3595,4644,0,21,5809,11815,2548,5050,7598,1292,814,711,2079,2406,15213
Armon Johnson,196,107,Bemidji State University,1920,56,525,86,187,25,34,7,18,79,169,13,49,62,67,15,1,50,49,204
Arnett Moultrie,211,112,Mississippi State University,1990,59,729,94,172,22,33,0,0,94,172,87,93,180,12,25,14,26,65,210
Aron Baynes,208,117,Washington State University,1986,295,4150,611,1189,321,396,1,7,610,1182,429,783,1212,157,57,124,229,579,1544
Arron Afflalo,196,95,"University of California, Los Angeles",1985,787,22649,3293,7355,1525,1845,943,2468,2350,4887,357,2000,2357,1485,378,140,947,1592,9054
Art Long,206,113,University of Cincinnati,1972,124,1431,176,398,49,107,4,6,172,392,151,228,379,54,32,53,105,255,405
Artis Gilmore*,218,108,Jacksonville University,1949,376,9342,1499,2480,1198,1740,0,3,1499,2477,720,1727,2447,425,148,436,739,1076,4196
Arvydas Macijauskas,193,97,NaN,1980,19,135,14,41,13,15,3,12,11,29,3,7,10,5,7,0,8,10,44
Arvydas Sabonis*,221,126,NaN,1964,470,11375,2082,4160,1329,1690,136,415,1946,3745,734,2702,3436,964,370,494,837,1290,5629
Ashraf Amaya,203,104,Southern Illinois University,1971,85,1248,133,292,112,177,1,2,132,290,133,222,355,36,29,13,67,180,379
Askia Jones,196,90,Kansas State University,1971,11,139,15,44,13,16,2,12,13,32,6,5,11,16,6,0,9,19,45
Audie Norris,206,104,Jackson State University,1960,78,1117,133,245,135,203,0,3,133,242,90,160,250,47,42,33,100,221,401
Austin Croshere,206,106,Providence College,1975,673,11580,1505,3698,1071,1248,434,1277,1071,2421,711,1972,2683,636,246,217,662,1099,4515
Austin Daye,211,99,Gonzaga University,1988,404,5300,731,1827,237,307,265,741,466,1086,174,815,989,279,146,148,261,619,1964
Austin Rivers,193,90,Duke University,1992,423,9401,1292,3103,550,840,315,931,977,2172,138,695,833,900,263,65,457,872,3449
Avery Bradley,188,81,University of Texas at Austin,1990,413,11619,2025,4578,438,567,520,1421,1505,3157,275,989,1264,702,446,87,565,885,5008
Avery Johnson,178,79,Southern University and A&M College,1965,1259,30161,4117,8603,1792,2541,32,215,4085,8388,428,1549,1977,6628,1155,176,2008,1896,10058
Awvee Storey,198,100,Arizona State University,1977,60,407,58,140,23,45,4,16,54,124,43,38,81,21,10,2,15,66,143
Axel Toupane,201,89,NaN,1992,29,399,35,88,13,17,15,48,20,40,8,25,33,15,9,8,6,52,98
B.J. Armstrong,201,102,NaN,1967,845,18979,2995,6282,1244,1454,452,1076,2543,5206,210,1226,1436,2690,574,47,956,1233,7686
B.J. Tyler,203,99,NaN,1969,55,809,72,189,35,50,16,51,56,138,13,49,62,174,36,2,97,58,195
Baron Davis,190,94,"University of California, Los Angeles",1979,939,31822,5468,13396,2625,3666,1531,4752,3937,8644,829,2685,3514,6778,1689,402,2585,2630,15092
Barry Stevens,196,88,Iowa State University,1963,2,6,1,2,0,0,0,0,1,2,2,0,2,0,0,0,0,1,2
Barry Sumpter,211,97,Austin Peay State University,1965,1,1,0,1,0,0,0,0,0,1,0,0,0,0,0,0,0,0,0
Bart Kofoed,193,95,University of Nebraska at Kearney,1964,111,702,58,150,43,70,3,16,55,134,16,40,56,108,19,4,56,95,162
Ben Bentil,206,106,Providence College,1995,3,10,0,3,0,0,0,1,0,2,0,2,2,0,0,0,1,1,0
Ben Coleman,206,106,University of Maryland,1961,297,5110,809,1582,469,617,0,8,809,1574,421,857,1278,190,137,140,429,843,2087
Ben Davis,206,108,University of Arizona,1972,40,154,21,59,12,26,0,0,21,59,30,23,53,5,6,2,7,25,54
Ben Gillery,213,106,Georgetown University,1965,24,84,6,19,13,23,0,0,6,19,7,16,23,2,2,4,5,29,25
Ben Gordon,190,90,University of Connecticut,1983,744,20366,3931,9092,2051,2394,1171,2921,2760,6171,333,1518,1851,1868,508,114,1551,1720,11084
Ben Handlogten,208,108,Western Michigan University,1973,38,469,68,130,27,44,0,1,68,129,45,75,120,19,10,9,28,87,163
Ben Hansbrough,190,92,University of Notre Dame,1987,28,200,15,45,21,27,6,23,9,22,2,16,18,21,7,2,18,23,57
Ben McDonald,203,95,"University of California, Irvine",1962,176,3692,463,989,125,172,10,44,453,945,215,353,568,236,77,17,149,487,1061
Ben McLemore,196,88,University of Kansas,1993,293,7476,993,2384,389,499,367,1043,626,1341,137,617,754,352,203,53,395,668,2742
Ben Poquette,206,106,Central Michigan University,1955,276,4360,500,1049,261,337,5,35,495,1014,329,719,1048,227,98,158,180,561,1266
Ben Uzoh,190,92,University of Tulsa,1988,78,1178,131,342,55,94,3,10,128,332,68,127,195,191,47,14,63,91,320
Ben Wallace,206,108,Virginia Union University,1974,1160,34290,2707,5773,1181,2848,7,55,2700,5718,3678,7408,11086,1542,1457,2254,1128,2199,6602
Beno Udrih,190,92,NaN,1982,982,20992,3114,6774,1134,1362,533,1522,2581,5252,360,1624,1984,3392,654,79,1388,1466,7895
Benoit Benjamin,213,113,Creighton University,1964,1019,26797,4401,8863,2465,3430,1,24,4400,8839,1808,5726,7534,1275,652,1859,2304,2834,11268
Bernard James,208,108,Florida State University,1985,92,761,76,153,51,75,0,3,76,150,85,127,212,13,17,61,34,105,203
Bernard King*,201,92,University of Tennessee,1956,389,12398,3382,6864,1900,2415,20,113,3362,6751,624,1188,1812,1395,304,64,1181,1096,8684
Bernard Robinson,198,95,University of Michigan,1980,159,2187,231,570,170,214,5,33,226,537,96,267,363,145,126,18,126,247,637
Bernard Thompson,198,95,"California State University, Fresno",1962,204,2935,410,934,258,327,0,17,410,917,164,188,352,266,127,27,181,391,1078
Bill Cartwright,216,111,University of San Francisco,1957,568,14401,2074,4229,1501,1978,0,0,2074,4229,961,2146,3107,784,231,195,900,1510,5649
Bill Curley,206,99,Boston College,1972,195,2115,211,469,108,149,3,12,208,457,163,214,377,77,81,57,112,451,533
Bill Edwards,203,97,Wright State University,1971,3,44,2,18,2,5,0,5,2,13,5,9,14,4,3,1,4,6,6
Bill Garnett,208,99,University of Portland,1940,145,2320,261,549,236,336,0,4,261,545,204,357,561,162,67,37,183,370,758
Bill Hanzlik,201,83,University of Notre Dame,1957,431,9285,1212,2843,1147,1478,41,188,1171,2655,379,819,1198,1244,445,121,647,1329,3612
Bill Jones,201,79,University of Iowa,1966,37,307,50,102,29,43,0,1,50,101,20,27,47,20,17,6,18,38,129
Bill Laimbeer,211,111,University of Notre Dame,1957,743,23932,3983,8071,1578,1856,196,582,3787,7489,1708,5386,7094,1456,515,621,1014,2412,9740
Bill Martin,201,92,Georgetown University,1962,84,860,168,374,61,75,0,9,168,365,53,83,136,58,30,9,74,129,397
Bill Walton*,211,95,"University of California, Los Angeles",1952,157,3305,510,953,290,420,0,2,510,951,315,860,1175,330,89,256,340,417,1310
Bill Wennington,213,111,St. John's University,1963,720,9740,1379,3006,538,684,5,36,1374,2970,688,1460,2148,440,226,248,440,1680,3301
Billy Donovan,180,77,Providence College,1965,44,364,44,109,17,21,0,7,44,102,5,20,25,87,16,1,42,33,105
Billy Knight,198,88,University of Pittsburgh,1952,136,1600,312,708,128,146,22,50,290,658,100,136,236,160,32,4,140,124,774
Billy McKinney,183,72,Northwestern University,1955,9,83,10,23,2,2,0,0,10,23,1,4,5,13,3,0,2,9,22
Billy Owens,203,99,Syracuse University,1969,724,20906,3346,7000,1418,2257,98,334,3248,6666,1691,3037,4728,2005,651,380,1559,2119,8208
Billy Paultz,211,106,St. John's University,1948,62,370,32,87,18,28,0,0,32,87,24,72,96,16,6,11,30,51,82
Billy Thomas,193,94,University of Kansas,1975,64,571,55,168,13,15,35,118,20,50,12,42,54,26,26,2,23,56,158
Billy Thompson,201,88,University of Louisville,1963,300,6697,1074,2128,416,617,2,13,1072,2115,670,945,1615,514,158,272,529,817,2566
Bimbo Coles,185,81,Virginia Polytechnic Institute and State Unive...,1968,968,23625,2923,6936,1481,1829,347,1229,2576,5707,529,1610,2139,3807,846,155,1466,2137,7674
Bismack Biyombo,206,115,NaN,1992,447,9557,809,1581,558,1009,0,1,809,1580,910,2035,2945,189,117,667,411,1031,2176
Bison Dele,206,106,University of Arizona,1969,413,10004,1847,3499,840,1215,2,14,1845,3485,853,1711,2564,440,320,355,822,1297,4536
Blair Rasmussen,213,113,University of Oregon,1962,532,11409,2248,4767,614,801,9,35,2239,4732,913,2093,3006,467,210,484,460,1623,5119
Blake Ahearn,188,86,Missouri State University,1984,19,226,21,77,32,33,14,47,7,30,1,21,22,22,7,0,22,27,88
Blake Griffin,208,113,University of Oklahoma,1989,471,16567,3906,7547,2225,3305,80,268,3826,7279,1154,3269,4423,1954,455,269,1159,1412,10117
Blue Edwards,193,90,East Carolina University,1965,771,19521,3202,6755,1314,1680,326,983,2876,5772,748,1758,2506,1486,771,313,1268,2066,8044
Bo Kimble,193,86,Loyola Marymount University,1966,105,1336,217,562,115,158,25,86,192,476,58,104,162,98,41,14,98,205,574
Bo Outlaw,203,95,University of Houston,1971,997,22668,2171,3833,1000,1939,4,40,2167,3793,1832,2969,4801,1568,925,1285,1152,2369,5346
Bob Hansen,198,86,University of Iowa,1961,588,11494,1656,3545,493,754,172,530,1484,3015,412,899,1311,972,371,49,555,1271,3977
Bob Martin,213,113,University of Minnesota,1969,54,549,41,93,31,51,0,0,41,93,38,81,119,18,8,34,29,108,113
Bob McAdoo*,206,95,University of North Carolina,1951,95,1863,400,797,184,243,0,1,400,796,104,294,398,102,28,71,144,234,984
Bob McCann,198,110,Morehead State University,1964,178,2385,296,618,146,253,1,5,295,613,154,314,468,104,80,79,134,349,739
Bob Sura,196,90,Florida State University,1973,737,17260,2120,5113,1566,2250,444,1382,1676,3731,686,1880,2566,2707,703,156,1336,1635,6250
Bob Thornton,208,102,"University of California, Irvine",1962,331,3979,385,850,236,417,2,11,383,839,313,511,824,114,85,38,245,681,1008
Boban Marjanovic,221,131,NaN,1988,89,801,177,306,134,172,0,0,177,306,119,205,324,30,18,35,39,79,488
Bobby Brown,193,92,Miami University,1923,251,3023,481,1254,96,118,156,491,325,763,46,140,186,424,73,8,223,279,1214
Bobby Cattage,206,113,Auburn University,1958,29,185,28,83,35,44,1,5,27,78,15,19,34,4,6,0,13,23,92
Bobby Hurley,183,74,Duke University,1971,330,5045,454,1261,305,396,69,257,385,1004,65,284,349,1057,143,7,471,439,1282
Bobby Jackson,185,83,University of Minnesota,1973,827,18179,2959,7107,1209,1525,770,2173,2189,4934,656,1872,2528,2084,749,73,1073,1468,7897
Bobby Jones,206,95,University of North Carolina,1951,288,4550,559,1096,403,504,37,120,522,976,234,473,707,353,173,107,282,571,1558
Bobby Phills,196,95,Southern University and A&M College,1969,467,13426,1957,4416,897,1215,342,878,1615,3538,411,1058,1469,1246,592,139,711,1106,5153
Bobby Portis,211,104,University of Arkansas,1995,126,2102,369,811,87,125,48,148,321,663,198,435,633,87,41,33,91,194,873
Bobby Simmons,201,95,DePaul University,1980,466,11513,1551,3552,709,862,378,955,1173,2597,559,1232,1791,710,396,83,522,1153,4189
Bojan Bogdanovic,198,92,NaN,1992,319,8135,1337,3015,631,724,508,1378,829,1637,160,862,1022,389,131,28,453,515,3813
Boniface N'Dong,213,89,NaN,1977,23,152,22,53,6,9,0,1,22,52,15,22,37,7,2,5,6,23,50
Bonzi Wells,196,95,Ball State University,1976,736,18567,3429,7530,1580,2270,257,802,3172,6728,962,2366,3328,1485,935,243,1479,1880,8695
Boris Diaw,203,113,NaN,1982,1202,32946,4409,8946,1177,1652,581,1693,3828,7253,1446,3900,5346,4222,743,588,2224,2596,10576
Bostjan Nachbar,206,100,NaN,1980,424,7471,959,2401,566,721,419,1134,540,1267,158,920,1078,384,180,105,377,946,2903
Bracey Wright,211,102,"University of California, Los Angeles",1962,26,325,45,111,27,34,12,37,33,74,10,29,39,20,10,1,14,14,129
Brad Daugherty,213,111,University of North Carolina,1965,548,20029,3823,7189,2741,3670,2,14,3821,7175,1207,4020,5227,2028,422,397,1511,1466,10389
Brad Davis,190,81,University of Maryland,1955,585,12114,1543,3170,872,1041,235,693,1308,2477,153,754,907,2504,413,100,720,1272,4193
Brad Lohaus,211,104,University of Iowa,1964,868,14133,2128,4831,538,727,491,1356,1637,3475,672,1915,2587,992,405,664,761,1742,5285
Brad Miller,211,110,Purdue University,1976,1014,28900,4104,8521,3152,3928,227,673,3877,7848,2110,5255,7365,2856,767,669,1612,2850,11587
Brad Sellers,213,95,Ohio State University,1962,457,7854,1129,2522,509,642,6,35,1123,2487,467,686,1153,468,154,268,381,752,2773
Brad Wright,211,102,"University of California, Los Angeles",1962,16,145,21,51,12,28,0,1,21,50,25,29,54,1,3,6,15,23,54
Bradley Beal,196,93,University of Florida,1993,324,10774,2122,4808,821,1032,663,1661,1459,3147,248,904,1152,1003,334,97,610,688,5728
Brandan Wright,211,102,"University of California, Los Angeles",1962,512,8396,1505,2473,512,754,0,15,1505,2458,712,1163,1875,239,246,510,242,678,3522
Branden Dawson,198,102,Michigan State University,1993,6,29,2,5,1,1,0,0,2,5,2,2,4,0,0,1,0,2,5
Brandin Knight,178,78,Stanford University,1975,1,3,0,1,0,0,0,0,0,1,0,0,0,1,0,0,0,0,0
Brandon Armstrong,196,85,Pepperdine University,1980,108,699,101,287,12,20,25,75,76,212,22,41,63,24,22,4,37,83,239
Brandon Bass,203,113,Louisiana State University,1985,758,16410,2558,5125,1447,1740,12,58,2546,5067,1139,2309,3448,608,295,479,718,1375,6575
Brandon Davies,208,108,Brigham Young University,1991,105,1421,164,402,82,127,18,78,146,324,114,161,275,88,60,22,93,210,428
Brandon Hunter,201,117,Ohio University,1980,67,630,90,189,40,82,0,3,90,186,75,112,187,22,17,8,44,82,220
Brandon Ingram,206,86,Duke University,1997,79,2279,276,686,133,214,55,187,221,499,60,257,317,166,50,36,116,158,740
Brandon Jennings,185,77,NaN,1989,670,19309,3027,7866,1548,1963,1035,3022,1992,4844,369,1551,1920,3672,772,107,1370,1158,8637
Brandon Knight,178,78,Stanford University,1975,445,13974,2467,5935,1206,1468,750,2073,1717,3862,250,1271,1521,1959,444,80,1208,896,6890
Brandon Roy,198,97,University of Washington,1984,326,11561,2224,4849,1366,1707,322,925,1902,3924,347,1041,1388,1517,335,76,595,630,6136
Brandon Rush,198,99,University of Kansas,1985,481,10564,1220,2861,288,408,522,1300,698,1561,187,1226,1413,468,222,262,400,620,3250
Brandon Williams,198,97,Davidson College,1975,18,163,17,57,4,8,3,10,14,47,7,11,18,3,8,3,12,22,41
Brendan Haywood,213,121,University of North Carolina,1979,893,21035,2386,4490,1470,2491,0,5,2386,4485,2359,3231,5590,485,346,1267,950,2252,6242
Brent Barry,198,83,Oregon State University,1971,970,25243,3109,6807,1416,1715,1485,3671,1624,3136,479,2472,2951,3045,1019,280,1393,1872,9119
Brent Price,185,74,University of Oklahoma,1968,418,7007,818,1918,482,585,363,938,455,980,175,509,684,1236,313,16,626,759,2481
Brent Scott,208,113,Rice University,1971,16,55,8,17,3,6,0,0,8,17,3,6,9,3,1,1,4,14,19
Brett Szabo,211,104,Augustana College (SD),1968,70,662,54,121,45,61,0,1,54,120,56,109,165,17,16,32,41,119,153
Brevin Knight,178,78,Stanford University,1975,838,20670,2263,5514,1391,1763,19,137,2244,5377,319,1746,2065,4996,1414,92,1530,2118,5936
Brian Cardinal,203,111,Purdue University,1977,456,6477,664,1628,537,624,243,653,421,975,286,764,1050,465,295,69,330,890,2108
Brian Cook,206,106,University of Illinois at Urbana-Champaign,1980,534,6725,1062,2491,253,318,328,881,734,1610,353,966,1319,294,157,154,315,956,2705
Brian Davis,190,81,University of Maryland,1955,68,374,40,126,50,68,1,3,39,123,21,34,55,22,16,4,19,34,131
Brian Evans,203,99,Indiana University,1973,190,2135,280,734,100,122,70,208,210,526,111,209,320,147,69,34,82,224,730
Brian Grant,206,115,Xavier University,1972,756,21417,3103,6332,1721,2306,6,28,3097,6304,1834,3788,5622,923,455,561,1235,2409,7933
Brian Howard,198,92,North Carolina State University,1967,95,1613,237,518,94,125,2,9,235,509,83,180,263,81,66,42,83,272,570
Brian Martin,206,96,University of Kansas,1962,16,42,6,14,0,4,0,0,6,14,2,6,8,0,0,2,4,14,12
Brian Oliver,193,95,Georgia Institute of Technology,1968,118,1182,155,400,74,105,5,22,150,378,31,92,123,114,45,6,78,121,389
Brian Quinnett,203,106,Washington State University,1966,177,1856,244,609,60,91,41,127,203,482,106,169,275,88,57,33,88,191,589
Brian Roberts,185,78,University of Dayton,1985,365,5677,827,1996,378,417,232,652,595,1344,64,399,463,775,142,21,295,403,2264
Brian Rowsom,206,99,University of North Carolina at Wilmington,1965,82,1092,158,347,139,170,2,3,156,344,101,172,273,47,29,23,44,130,457
Brian Scalabrine,206,109,University of Southern California,1978,520,6772,590,1512,234,299,180,523,410,989,275,759,1034,436,157,121,341,819,1594
Brian Shaw,198,86,"University of California, Santa Barbara",1966,1065,24619,2952,7378,1046,1342,464,1534,2488,5844,860,2742,3602,4429,853,291,1862,2212,7414
Brian Skinner,206,115,Baylor University,1976,722,12795,1380,2784,538,984,2,7,1378,2777,1102,2247,3349,361,312,624,604,1491,3300
Briante Weber,188,74,Virginia Commonwealth University,1992,54,748,78,198,28,40,2,30,76,168,32,70,102,84,42,8,34,56,186
Brice Johnson,208,95,University of Utah,1979,3,9,2,7,0,0,0,0,2,7,1,2,3,1,2,1,1,0,4
Britton Johnsen,208,95,University of Utah,1979,26,377,23,81,7,16,1,16,22,65,20,35,55,16,8,1,17,38,54
Brook Lopez,213,124,Stanford University,1988,562,18118,4044,7998,2219,2795,137,418,3907,7580,1486,2519,4005,867,328,972,1155,1573,10444
Brook Steppe,196,88,Georgia Institute of Technology,1959,115,1395,211,455,192,229,8,19,203,436,59,91,150,133,45,8,110,149,622
Brooks Thompson,193,87,Oklahoma State University,1970,265,2936,463,1141,83,131,255,670,208,471,49,220,269,488,152,8,257,377,1264
Bruce Bowen,201,83,"California State University, Fullerton",1971,942,24930,2017,4955,607,1056,845,2140,1172,2815,496,2028,2524,1123,735,351,665,2048,5486
Bruce Douglas,190,88,University of Illinois at Urbana-Champaign,1964,8,98,7,24,0,4,0,1,7,23,5,9,14,17,9,0,9,9,14
Bruno Caboclo,206,98,NaN,1995,23,106,11,40,0,0,5,16,6,24,7,7,14,5,4,3,10,9,27
Bruno Sundov,218,99,NaN,1980,107,557,83,232,13,25,5,24,78,208,34,83,117,19,15,14,33,115,184
Bryan Warrick,196,88,Saint Joseph's University,1959,130,2083,255,537,152,193,7,28,248,509,30,166,196,383,77,10,176,243,669
Bryant Reeves,213,124,Oklahoma State University,1973,395,12071,1999,4208,945,1345,2,27,1997,4181,856,1889,2745,623,200,302,744,1365,4945
Bryant Stith,196,94,University of Virginia,1970,586,16417,2021,4767,1598,1900,306,931,1715,3836,605,1378,1983,1178,594,130,776,1092,5946
Bryce Cotton,185,74,Providence College,1992,31,237,37,89,15,18,7,26,30,63,3,15,18,21,10,0,22,10,96
Bryce Dejean-Jones,198,94,Iowa State University,1992,14,279,28,69,11,21,12,32,16,37,8,40,48,15,10,2,11,17,79
Bryce Drew,188,83,Valparaiso University,1974,243,3970,419,1096,93,112,150,404,269,692,56,239,295,524,123,10,209,291,1081
Bryn Forbes,190,86,Michigan State University,1993,36,285,36,99,5,6,17,53,19,46,2,21,23,23,1,0,11,20,94
Bryon Russell,201,102,"California State University, Long Beach",1970,841,19805,2274,5272,1430,1906,685,1856,1589,3416,752,2162,2914,1085,874,203,835,1984,6663
Bubba Wells,196,104,Austin Peay State University,1974,39,395,48,116,31,43,1,6,47,110,22,46,68,34,15,4,31,40,128
Buck Johnson,201,86,University of Alabama,1964,505,11849,1922,3942,766,1038,7,62,1915,3880,623,1137,1760,856,404,252,664,1403,4617
Buck Williams,203,97,University of Maryland,1960,1062,33675,4860,8942,3121,4570,5,21,4855,8921,3459,6526,9985,1284,824,781,2066,3414,12846
Buddy Hield,193,97,University of Oklahoma,1993,164,3776,654,1536,128,152,296,758,358,778,70,468,538,242,76,18,202,230,1732
Butch Carter,196,81,Indiana University,1958,87,1413,228,524,121,148,11,45,217,479,40,63,103,175,59,5,123,179,588
Butch Graves,190,90,Yale University,1962,4,11,2,6,1,5,0,1,2,5,0,2,2,1,1,0,1,4,5
Byron Dinkins,185,77,University of North Carolina at Charlotte,1967,57,660,72,177,42,48,1,9,71,168,13,51,64,113,23,2,63,60,187
Byron Houston,196,113,Oklahoma State University,1969,214,2674,307,673,211,312,10,39,297,634,237,411,648,114,103,86,173,543,835
Byron Irvin,196,86,University of Missouri,1966,87,849,165,350,114,158,7,20,158,330,56,67,123,73,44,3,59,77,451
Byron Mullens,213,124,Ohio State University,1989,234,3860,630,1531,183,265,144,437,486,1094,224,658,882,167,89,109,214,399,1587
Byron Scott,190,88,Arizona State University,1961,999,28515,5584,11578,2374,2846,767,2059,4817,9519,627,2196,2823,2552,1143,257,1481,1877,14309
C.J. McCollum,190,86,NaN,1991,260,7025,1566,3415,529,627,467,1131,1099,2284,128,561,689,717,226,75,451,523,4128
C.J. Miles,185,79,NaN,1983,715,14928,2525,6047,948,1175,1008,2795,1517,3252,328,1424,1752,811,528,214,651,1564,7006
C.J. Watson,211,117,NaN,1984,600,12093,1516,3617,841,1036,471,1263,1045,2354,218,938,1156,1485,559,67,650,894,4344
C.J. Wilcox,203,90,NaN,1995,66,376,50,135,13,16,19,57,31,78,6,25,31,30,15,4,18,30,132
Cal Bowdler,208,111,Old Dominion University,1977,142,1383,163,403,96,125,2,11,161,392,90,182,272,29,42,45,43,155,424
Calbert Cheaney,201,94,Indiana University,1971,825,22007,3366,7227,890,1288,204,684,3162,6543,732,1878,2610,1398,659,198,994,2074,7826
Caldwell Jones,211,98,Albany State University,1950,423,7842,562,1183,421,542,1,21,561,1162,537,1422,1959,332,146,380,442,1159,1546
Calvin Booth,211,104,Pennsylvania State University,1976,480,5917,646,1417,329,444,2,10,644,1407,427,947,1374,201,146,499,250,912,1623
Calvin Natt,198,99,University of Louisiana at Monroe,1957,237,6087,1374,2666,912,1166,2,12,1372,2654,437,901,1338,496,164,55,416,448,3662
Cameron Bairstow,206,113,University of New Mexico,1990,36,167,16,54,11,13,1,5,15,49,10,26,36,7,4,4,7,27,44
Cameron Payne,190,83,Murray State University,1994,119,1622,242,664,29,40,90,283,152,381,15,166,181,218,64,16,102,184,603
Campy Russell,196,98,University of Michigan,1944,3,24,2,7,2,3,0,1,2,6,0,5,5,3,0,0,5,3,6
Carey Scurry,201,85,Long Island University,1962,213,2831,375,784,226,338,11,40,364,744,254,354,608,242,231,166,238,457,987
Caris LeVert,201,92,University of Michigan,1994,57,1237,171,380,67,93,59,184,112,196,23,165,188,110,49,8,59,91,468
Carl Henry,198,92,University of Kansas,1960,28,149,31,67,12,17,4,10,27,57,8,11,19,4,5,0,9,11,78
Carl Herrera,206,97,University of Houston,1966,493,8349,1069,2259,406,635,2,15,1067,2244,602,1150,1752,265,249,211,463,976,2546
Carl Landry,206,112,Purdue University,1983,669,16001,2930,5516,1917,2447,10,37,2920,5479,1347,2001,3348,484,311,298,848,1638,7787
Carl Thomas,193,79,Eastern Michigan University,1969,106,960,126,316,34,53,43,132,83,184,23,84,107,47,45,15,43,88,329
Carldell Johnson,178,81,University of Alabama at Birmingham,1983,15,119,11,35,1,3,4,15,7,20,1,8,9,22,8,0,7,11,27
Carlos Arroyo,188,91,Florida International University,1979,817,14849,1935,4460,1048,1307,183,526,1752,3934,301,1041,1342,2468,404,36,953,1237,5101
Carlos Boozer,206,117,Duke University,1981,861,26901,5847,11221,2281,3158,1,14,5846,11207,2037,6155,8192,1928,765,346,1824,2612,13976
Carlos Clark,193,95,University of Mississippi,1960,62,562,64,152,41,53,0,5,64,147,29,40,69,48,35,2,42,66,169
Carlos Delfino,198,104,NaN,1982,507,11580,1472,3669,493,650,678,1856,794,1813,287,1528,1815,887,461,88,509,827,4115
Carlos Rogers,211,99,Tennessee State University,1971,319,6030,935,1749,406,722,32,126,903,1623,538,801,1339,200,138,243,311,550,2308
Carlton McKinney,193,86,Southern Methodist University,1964,9,113,10,41,2,4,0,1,10,40,4,9,13,7,6,1,7,16,22
Carmelo Anthony,203,108,Syracuse University,1984,1053,38085,9300,20575,6259,7680,1267,3638,8033,16937,1860,5132,6992,3278,1098,517,2931,3057,26126
Caron Butler,201,103,University of Connecticut,1980,1011,32535,5259,12183,2819,3332,886,2538,4373,9645,1228,3849,5077,2245,1326,257,1814,2442,14223
Carrick Felix,198,91,Arizona State University,1990,7,38,7,14,3,4,2,5,5,9,1,5,6,4,0,0,4,4,19
Cartier Martin,201,99,Kansas State University,1984,320,4611,591,1498,223,302,294,786,297,712,126,515,641,170,135,35,181,436,1699
Casey Jacobsen,198,97,Stanford University,1981,371,7118,641,1618,478,617,275,771,366,847,153,530,683,417,154,32,281,476,2035
Casey Shaw,211,117,University of Toledo,1975,9,14,1,8,0,0,0,0,1,8,3,0,3,0,0,0,2,2,2
Casper Ware,178,79,"California State University, Long Beach",1990,9,116,18,42,5,6,7,21,11,21,0,9,9,10,8,0,5,11,48
Cedric Ball,203,95,University of North Carolina at Charlotte,1968,7,26,3,8,2,2,0,0,3,8,5,6,11,0,0,2,2,5,8
Cedric Bozeman,198,93,"University of California, Los Angeles",1983,23,199,11,39,2,6,2,13,9,26,3,20,23,9,5,2,9,32,26
Cedric Ceballos,198,86,"California State University, Fullerton",1969,746,17687,4001,8085,1913,2539,304,1005,3697,7080,1463,2452,3915,867,532,229,1180,1336,10219
Cedric Henderson,203,95,University of Georgia,1965,276,6214,791,1813,319,444,6,43,785,1770,176,595,771,419,228,111,409,582,1907
Cedric Hunter,183,81,University of Kansas,1965,1,1,0,0,0,0,0,0,0,0,0,0,0,0,0,0,0,0,0
Cedric Jackson,190,86,Cleveland State University,1986,24,148,12,40,14,24,2,12,10,28,4,12,16,28,6,4,22,14,40
Cedric Lewis,208,106,University of Maryland,1969,3,4,2,3,0,0,0,0,2,3,2,0,2,0,1,0,0,0,4
Cedric Maxwell,203,92,University of North Carolina at Charlotte,1955,366,8737,1101,2163,1394,1765,0,9,1101,2154,763,1152,1915,771,197,84,630,823,3596
Cedric Simmons,206,106,North Carolina State University,1986,107,876,85,210,30,85,0,0,85,210,66,109,175,16,14,41,38,107,200
Cezary Trybanski,218,108,NaN,1979,29,116,5,28,6,14,0,0,5,28,6,10,16,1,2,8,12,19,16
Chad Gallagher,208,115,Creighton University,1969,2,3,3,3,0,0,0,0,3,3,0,0,0,0,0,0,0,2,6
Chandler Parsons,208,104,University of Florida,1988,374,12005,1948,4177,587,826,603,1615,1345,2562,337,1468,1805,1086,371,135,587,764,5086
Channing Frye,211,115,University of Arizona,1983,871,19936,2936,6673,877,1066,1069,2747,1867,3926,786,3263,4049,877,462,550,796,2269,7818
Charles Barkley*,198,114,Auburn University,1963,1073,39330,8435,15605,6349,8643,538,2020,7897,13585,4260,8286,12546,4215,1648,888,3376,3287,23757
Charles Claxton,213,120,University of Georgia,1970,3,7,1,2,0,2,0,0,1,2,2,0,2,0,0,1,1,4,2
Charles Davis,188,72,Wake Forest University,1949,323,3847,729,1687,203,253,18,118,711,1569,282,471,753,246,95,38,236,507,1679
Charles Jenkins,190,99,Hofstra University,1989,169,1775,228,533,58,83,5,24,223,509,24,108,132,258,63,10,102,129,519
Charles Jones,206,97,Albany State University,1957,1042,18906,1262,2700,727,1172,59,194,1203,2506,1478,2821,4299,990,610,1331,803,2574,3310
Charles O'Bannon,196,94,"University of California, Los Angeles",1975,48,399,50,125,20,23,0,4,50,121,32,35,67,29,11,4,17,37,120
Charles Oakley,203,102,Virginia Union University,1963,1282,40280,4835,10263,2679,3522,68,269,4767,9994,3924,8281,12205,3217,1351,384,2785,4421,12417
Charles Pittman,203,99,University of Maryland,1958,137,2133,234,445,208,287,0,2,234,443,189,284,473,127,57,44,207,284,676
Charles Shackleford,208,102,North Carolina State University,1966,303,4614,698,1444,229,350,0,5,698,1439,497,951,1448,170,119,148,276,664,1625
Charles Smith,208,104,University of Pittsburgh,1965,908,21157,3678,7951,2352,3087,122,453,3556,7498,1412,2515,3927,1132,653,954,1328,2514,9830
Charles Thomas,190,79,Eastern Michigan University,1969,36,156,18,51,10,15,2,17,16,34,6,16,22,22,4,1,17,20,48
Charlie Bell,190,90,Michigan State University,1979,383,9412,1195,2902,384,499,438,1219,757,1683,182,637,819,859,303,31,367,753,3212
Charlie Criss,173,74,New Mexico State University,1948,4,115,7,17,4,6,0,2,7,15,2,12,14,22,3,0,11,5,18
Charlie Sitton,203,95,Oregon State University,1962,43,304,39,94,13,25,0,2,39,92,24,36,60,26,7,6,19,50,91
Charlie Villanueva,211,105,University of Connecticut,1984,656,13578,2652,6097,788,1021,716,2101,1936,3996,795,2224,3019,549,329,349,650,1453,6808
Charlie Ward,188,86,Florida State University,1970,701,15332,1560,3818,528,686,723,1960,837,1858,254,1538,1792,2754,840,139,1134,1383,4371
Chase Budinger,201,94,University of Arizona,1988,473,8927,1292,3005,448,569,437,1258,855,1747,281,1109,1390,537,245,75,354,547,3469
Chasson Randle,188,83,Stanford University,1993,52,598,80,196,82,86,32,94,48,102,12,52,64,68,18,4,38,78,274
Chauncey Billups,190,91,University of Colorado,1976,1274,40323,5767,13936,5524,6172,2245,5810,3522,8126,599,3012,3611,6843,1322,204,2666,2648,19303
Cheick Diallo,206,99,University of Kansas,1996,17,199,36,76,15,21,0,0,36,76,23,50,73,4,4,7,7,17,87
Cheikh Samb,216,111,NaN,1984,40,197,15,68,7,16,0,6,15,62,23,32,55,2,7,22,7,22,37
Cherokee Parks,196,95,Idaho State University,1973,537,8513,1002,2122,343,539,8,44,994,2078,635,1297,1932,311,232,342,322,1053,2355
Chinanu Onuaku,208,111,University of Louisville,1996,5,52,5,7,4,4,0,0,5,7,2,8,10,3,3,1,4,6,14
Chris Andersen,208,111,Blinn College,1978,722,12675,1374,2584,1093,1668,19,82,1355,2502,1212,2379,3591,349,327,1004,522,1371,3860
Chris Anstey,213,112,NaN,1975,155,2157,303,734,203,269,4,29,299,705,178,356,534,127,78,65,147,373,813
Chris Babb,196,102,Iowa State University,1990,14,132,8,30,0,0,6,27,2,3,4,13,17,3,6,0,3,13,22
Chris Bosh,211,106,Georgia Institute of Technology,1984,893,31936,6209,12581,4466,5591,305,910,5904,11671,1927,5665,7592,1795,730,932,1807,2159,17189
Chris Carr,196,93,Southern Illinois University,1974,393,6116,1002,2454,503,622,219,646,783,1808,240,662,902,401,131,63,455,660,2726
Chris Childs,190,88,Boise State University,1967,618,15476,1423,3531,822,1005,404,1188,1019,2343,220,1290,1510,2988,549,69,1220,1828,4072
Chris Copeland,206,108,University of Colorado,1984,171,2111,366,858,112,149,154,422,212,436,65,207,272,107,32,30,129,237,998
Chris Corchiani,183,83,North Carolina State University,1968,122,1418,145,335,149,184,21,81,124,254,28,108,136,259,79,4,128,177,460
Chris Crawford,206,106,Marquette University,1975,252,3985,609,1393,366,444,70,202,539,1191,206,341,547,154,101,80,232,492,1654
Chris Douglas-Roberts,201,90,University of Memphis,1987,222,4381,574,1309,339,408,84,255,490,1054,83,389,472,254,128,55,200,287,1571
Chris Dudley,188,81,University of Washington,1950,950,17677,1537,3735,749,1690,0,5,1537,3730,2408,3472,5880,414,375,1099,824,2492,3823
Chris Duhon,185,83,Duke University,1982,606,15526,1353,3440,591,754,649,1788,704,1652,200,1164,1364,2690,471,36,925,965,3946
Chris Engler,211,111,University of Wyoming,1959,136,953,98,230,65,85,0,0,98,230,102,170,272,31,23,38,57,149,261
Chris Garner,178,70,University of Memphis,1975,46,442,30,107,8,13,4,21,26,86,9,27,36,63,28,5,34,68,72
Chris Gatling,208,99,Old Dominion University,1967,951,19056,3939,7726,2252,3388,70,286,3869,7440,1717,3492,5209,635,653,479,1515,2589,10200
Chris Herren,188,89,"California State University, Fresno",1975,70,1005,74,220,36,52,40,122,34,98,16,57,73,167,29,2,62,117,224
Chris Hunter,211,108,University of Michigan,1984,60,783,109,217,52,69,0,4,109,213,56,111,167,37,13,35,30,132,270
Chris Jefferies,203,102,"California State University, Fresno",1980,93,1056,129,338,55,83,52,138,77,200,26,91,117,36,27,30,83,128,365
Chris Jent,201,99,Ohio State University,1970,6,88,15,32,1,2,6,14,9,18,5,11,16,8,0,0,5,15,37
Chris Johnson,183,77,University of California,1949,288,3710,398,940,181,231,132,434,266,506,153,401,554,126,140,102,158,413,1109
Chris Kaman,213,120,Central Michigan University,1982,735,19642,3432,7023,1343,1808,1,24,3431,6999,1487,4095,5582,921,322,931,1544,1968,8208
Chris King,203,97,Wake Forest University,1969,103,2058,271,640,105,166,46,120,225,520,108,203,311,116,74,34,119,183,693
Chris McCray,196,87,University of Maryland,1984,5,12,0,3,0,0,0,0,0,3,0,0,0,0,0,0,2,1,0
Chris McCullough,211,90,Syracuse University,1995,56,522,76,173,17,33,15,48,61,125,43,63,106,13,32,16,21,53,184
Chris McNealy,201,95,San Jose State University,1961,108,1864,181,397,104,158,0,0,181,397,160,334,494,110,90,30,116,274,466
Chris Mihm,213,120,University of Texas at Austin,1979,512,10088,1439,3112,863,1235,3,13,1436,3099,1021,1694,2715,244,165,507,625,1472,3744
Chris Mills,198,97,University of Arizona,1970,568,17282,2391,5541,1136,1391,439,1251,1952,4290,772,2036,2808,1063,421,247,726,1532,6357
Chris Morris,203,95,Auburn University,1966,747,18748,3144,7136,1399,1894,497,1625,2647,5511,1516,2028,3544,1182,917,540,1171,1750,8184
Chris Mullin*,198,90,St. John's University,1963,986,32163,6740,13243,3616,4178,815,2120,5925,11123,1026,3008,4034,3450,1530,549,2315,2050,17911
Chris Munk,206,102,University of Southern California,1967,11,29,3,7,7,12,0,0,3,7,5,9,14,1,1,2,5,5,13
Chris Owens,201,111,University of Texas at Austin,1979,1,6,2,3,0,0,0,0,2,3,1,0,1,0,0,0,1,0,4
Chris Paul,183,79,Wake Forest University,1985,834,29646,5493,11614,3627,4189,997,2692,4496,8922,569,3115,3684,8251,1911,90,2024,2055,15610
Chris Porter,201,98,Auburn University,1978,51,1147,173,445,94,141,0,5,173,440,89,100,189,61,45,6,59,111,440
Chris Quinn,188,83,University of Notre Dame,1983,241,3303,381,956,169,209,161,427,220,529,30,236,266,455,102,8,137,249,1092
Chris Richard,206,122,University of Florida,1984,70,780,56,116,23,38,0,0,56,116,71,123,194,25,18,16,38,133,135
Chris Robinson,196,90,Western Kentucky University,1974,111,1509,199,530,32,58,82,221,117,309,41,122,163,143,66,17,100,185,512
Chris Singleton,203,104,Florida State University,1989,148,2605,233,620,88,139,58,182,175,438,112,360,472,92,117,57,100,325,612
Chris Smith,208,104,University of Pittsburgh,1965,226,3958,425,976,231,324,59,161,366,815,61,230,291,627,118,56,219,346,1140
Chris Taft,208,117,University of Pittsburgh,1985,17,144,23,38,1,6,0,0,23,38,19,17,36,2,2,7,2,25,47
Chris Washburn,211,102,North Carolina State University,1965,109,905,129,307,54,113,0,1,129,306,92,159,251,28,16,24,73,109,312
Chris Webber,206,111,University of Michigan,1973,959,35038,8036,16946,2817,4294,283,938,7753,16008,2525,6648,9173,4032,1351,1294,2602,3057,19172
Chris Welp,213,111,University of Washington,1964,136,1371,163,375,98,141,0,1,163,374,106,207,313,52,40,62,81,317,424
Chris Whitney,183,76,Clemson University,1971,630,11104,1351,3459,789,906,602,1692,749,1767,100,782,882,1758,380,34,690,1076,4093
Chris Wilcox,208,100,University of Maryland,1982,767,15052,2542,4704,1139,1767,0,24,2542,4680,1184,2579,3763,554,381,296,852,1837,6223
Chris Wright,203,102,University of Dayton,1988,35,316,45,82,30,46,0,1,45,81,29,36,65,9,14,18,14,39,120
Christian Eyenga,196,95,NaN,1989,58,1151,142,356,26,44,27,97,115,259,35,116,151,45,40,38,53,92,337
Christian Laettner,211,106,Duke University,1969,1020,29918,4755,9863,3451,4204,105,405,4650,9458,1923,4786,6709,2545,1059,792,2256,3286,13066
Christian Wood,211,99,"University of Nevada, Las Vegas",1995,30,252,34,76,24,36,4,16,30,60,27,40,67,5,8,13,9,22,96
Chuck Aleksinas,211,117,University of Connecticut,1959,74,1114,161,337,55,75,0,1,161,336,87,183,270,36,15,15,72,171,377
Chuck Hayes,198,108,University of Kentucky,1983,705,12569,1103,2234,336,535,0,15,1103,2219,1188,2265,3453,816,512,249,494,1580,2542
Chuck Nevitt,226,98,North Carolina State University,1959,178,888,103,254,71,112,0,0,103,254,89,165,254,26,21,118,85,232,277
Chuck Person,203,99,Auburn University,1964,943,28941,5576,12176,1486,2056,1220,3370,4356,8806,1162,3601,4763,2645,683,197,1952,2565,13858
Chucky Atkins,180,72,University of South Florida,1974,864,20973,2931,7192,1188,1534,1127,3137,1804,4055,231,1192,1423,2876,563,42,1220,1565,8177
Chucky Brown,201,97,North Carolina State University,1968,895,14585,2038,4192,814,1177,25,119,2013,4073,780,1819,2599,680,278,270,638,1476,4915
Clarence Weatherspoon,198,108,University of Southern Mississippi,1970,1046,30929,4397,9356,2676,3610,10,52,4387,9304,2398,5246,7644,1465,995,883,1584,2297,11480
Clark Kellogg,201,102,Ohio State University,1961,100,3077,709,1428,357,469,12,29,697,1399,282,621,903,307,119,34,296,318,1787
Claude Gregory,203,92,University of Wisconsin,1958,25,315,62,136,12,36,0,1,62,135,39,58,97,16,10,13,24,38,136
Cleanthony Early,203,95,Wichita State University,1991,56,801,88,254,39,52,26,99,62,155,26,97,123,42,26,15,49,73,241
Clemon Johnson,208,108,Florida Agricultural and Mechanical University,1956,285,3718,359,741,179,272,0,3,359,738,370,557,927,86,72,172,146,482,897
Cliff Alexander,203,111,University of Kansas,1995,8,36,5,10,0,0,0,0,5,10,2,4,6,0,1,2,1,1,10
Cliff Levingston,203,95,Wichita State University,1961,688,14337,1973,3818,1008,1467,5,29,1968,3789,1434,2096,3530,591,467,479,679,1893,4959
Cliff Robinson,206,99,University of Southern California,1960,278,8623,1939,4135,815,1095,4,22,1935,4113,549,1483,2032,596,336,162,692,787,4697
Clifford Lett,190,77,University of Florida,1965,11,127,16,37,6,9,0,1,16,36,1,6,7,8,2,1,10,17,38
Clifford Robinson,206,99,University of Southern California,1960,1451,44250,7591,17398,3622,5262,1320,3708,6271,13690,1906,4609,6515,3198,1464,1443,2568,4356,20124
Clifford Rozier,211,111,University of Louisville,1972,215,3721,429,879,156,330,2,13,427,866,478,653,1131,129,102,157,191,532,1016
Clint Capela,206,98,NaN,1995,154,3112,607,989,178,411,0,1,607,988,382,674,1056,113,94,181,152,383,1392
Clint McDaniel,193,81,University of Arkansas,1972,12,71,8,23,12,16,2,6,6,17,3,7,10,7,5,0,2,10,30
Clint Richardson,190,88,Seattle University,1956,234,5151,736,1607,258,310,8,29,728,1578,180,369,549,770,144,30,299,402,1738
Clinton Smith,198,95,Cleveland State University,1964,46,386,52,121,30,42,0,2,52,119,28,32,60,49,14,1,27,39,134
Clinton Wheeler,185,83,William Paterson University,1959,115,1221,152,306,55,74,0,2,152,304,53,49,102,211,90,2,100,89,359
Clyde Drexler*,201,95,University of Houston,1962,1080,38857,8654,18352,4939,6235,973,3007,7681,15345,2655,4267,6922,6334,2236,735,3040,3282,23220
Coby Karl,196,97,Boise State University,1983,31,297,31,90,16,22,8,35,23,55,11,39,50,39,10,4,25,32,86
Cody Zeller,213,108,Indiana University,1992,279,6402,828,1657,581,792,2,13,826,1644,488,1087,1575,362,193,211,282,719,2239
Cole Aldrich,211,113,University of Kansas,1988,363,3728,474,890,190,258,0,0,474,890,361,875,1236,189,140,255,221,558,1138
Conner Henry,201,88,"University of California, Santa Barbara",1963,186,1512,216,572,112,148,66,174,150,398,40,126,166,204,42,12,130,142,610
Corey Beck,185,86,University of Arkansas,1971,112,1131,111,245,60,91,4,6,107,239,42,111,153,143,52,11,100,160,286
Corey Benjamin,198,90,Oregon State University,1978,153,2191,317,812,144,221,57,197,260,615,84,175,259,143,71,48,164,316,835
Corey Brewer,206,84,University of Florida,1986,942,21916,3170,7512,1483,2070,578,2084,2592,5428,711,1976,2687,1503,1183,254,1153,2024,8401
Corey Crowder,196,97,Kentucky Wesleyan College,1969,58,357,45,122,17,24,13,34,32,88,17,27,44,18,8,2,15,36,120
Corey Gaines,190,88,Loyola Marymount University,1965,80,1002,92,217,53,72,11,48,81,169,12,57,69,247,39,4,72,98,248
Corey Maggette,198,98,Duke University,1979,827,23358,4065,8969,4605,5599,463,1431,3602,7538,915,3107,4022,1696,590,139,1874,2338,13198
Corey Williams,188,86,Oklahoma State University,1970,39,288,36,98,19,23,1,4,35,94,20,17,37,29,6,2,13,30,92
Corie Blount,206,108,University of Cincinnati,1969,808,12810,1240,2685,460,788,5,38,1235,2647,1422,2094,3516,586,438,328,656,1749,2945
Corliss Williamson,188,86,Oklahoma State University,1970,963,21962,4201,8586,2281,3191,6,48,4195,8538,1428,2335,3763,1111,550,297,1512,2653,10689
Corsley Edwards,206,124,Central Connecticut State University,1979,10,110,10,31,7,12,0,0,10,31,12,13,25,3,3,4,2,19,27
Cory Alexander,185,83,University of Virginia,1973,367,6145,758,1908,346,454,303,845,455,1063,95,532,627,1043,333,48,579,612,2165
Cory Blackwell,198,95,University of Wisconsin,1963,60,551,87,237,28,55,0,2,87,235,42,54,96,26,25,3,44,55,202
Cory Carr,190,95,Texas Tech University,1975,42,624,71,216,24,32,5,30,66,186,8,41,49,66,21,7,46,66,171
Cory Higgins,196,81,University of Colorado,1989,44,455,58,179,43,62,5,25,53,154,8,30,38,41,8,6,39,45,164
Cory Jefferson,206,98,Baylor University,1990,58,581,84,189,35,60,2,16,82,173,53,108,161,16,10,22,20,69,205
Cory Joseph,190,87,University of Texas at Austin,1991,364,7083,962,2102,440,573,115,363,847,1739,183,638,821,904,232,71,353,501,2479
Coty Clarke,201,105,University of Arkansas,1992,3,6,2,4,0,0,2,2,0,2,0,1,1,0,0,0,1,0,6
Courtney Alexander,185,83,University of Virginia,1973,252,5449,894,2125,462,567,58,167,836,1958,166,386,552,289,156,23,278,516,2308
Courtney Fortson,180,83,University of Arkansas,1988,20,190,22,64,20,30,6,26,16,38,12,18,30,20,6,0,20,10,70
Courtney Lee,196,90,Western Kentucky University,1985,835,23162,3110,6854,1031,1212,880,2290,2230,4564,376,1834,2210,1375,840,242,798,1426,8131
Courtney Sims,208,111,University of Michigan,1983,7,37,6,13,0,0,0,0,6,13,5,5,10,1,0,0,2,4,12
Cozell McQueen,211,106,North Carolina State University,1962,3,7,3,3,0,0,0,0,3,3,3,5,8,0,0,1,0,1,6
Craig Brackins,208,104,Iowa State University,1987,17,121,13,49,1,2,3,14,10,35,7,12,19,9,1,1,4,9,30
Craig Ehlo,198,81,Washington State University,1961,866,21008,2966,6552,916,1329,621,1684,2345,4868,992,2138,3130,2450,986,232,1222,1682,7469
Craig Hodges,188,86,"California State University, Long Beach",1960,668,14133,2232,4805,598,696,694,1627,1538,3178,273,623,896,1677,502,27,703,1218,5756
Craig Neal,196,74,Georgia Institute of Technology,1964,116,1125,104,281,41,68,23,77,81,204,16,58,74,273,52,8,127,166,272
Craig Smith,201,113,Boston College,1983,403,6826,1221,2207,637,963,1,27,1220,2180,543,1024,1567,322,183,91,413,957,3080
Cristiano Felicio,208,124,NaN,1992,97,1361,168,294,85,128,0,4,168,290,154,259,413,66,31,29,46,141,421
Cuonzo Martin,196,96,Purdue University,1971,7,32,3,12,0,2,3,5,0,7,2,1,3,3,1,0,2,2,9
Curtis Borchardt,213,108,Stanford University,1980,83,1117,96,228,66,89,0,1,96,227,99,179,278,64,14,46,70,200,258
Curtis Kitchen,206,106,University of South Florida,1964,6,31,3,6,3,4,0,1,3,5,4,5,9,1,2,3,0,4,9
Cuttino Mobley,193,86,University of Rhode Island,1975,813,30006,4727,10911,2409,2889,1235,3209,3492,7702,588,2543,3131,2203,952,343,1653,1862,13098
D'Angelo Russell,188,86,NaN,1994,143,4070,743,1823,287,378,265,754,478,1069,78,418,496,569,180,29,372,272,2038
D.J. Augustin,206,106,NaN,1988,866,20471,2723,6742,1862,2161,1080,2892,1643,3850,211,1333,1544,3355,522,35,1324,1299,8388
D.J. Kennedy,211,111,NaN,1992,2,59,5,12,0,2,2,4,3,8,1,6,7,3,2,0,3,7,12
D.J. Stephens,203,97,NaN,1990,3,15,3,7,1,1,0,0,3,7,1,4,5,0,0,0,0,0,7
D.J. Strawberry,211,113,NaN,1977,33,270,29,92,9,19,6,25,23,67,9,19,28,30,12,6,11,36,73
D.J. White,190,90,NaN,1988,185,2796,459,906,159,221,1,5,458,901,160,435,595,99,51,77,79,276,1078
DaJuan Summers,203,104,Georgetown University,1988,83,820,103,268,43,67,29,79,74,189,24,58,82,29,18,8,37,104,278
Daequan Cook,190,83,University of Portland,1958,377,6434,809,2223,165,204,468,1323,341,900,82,682,764,262,128,55,192,504,2251
Dahntay Jones,190,83,University of Houston,1976,702,10815,1285,2961,927,1231,118,374,1167,2587,276,907,1183,577,283,150,545,1325,3615
Dajuan Wagner,183,77,University of Texas at Austin,1922,103,2202,354,967,164,213,92,287,262,680,29,113,142,195,69,14,136,212,964
Dale Davis,211,104,Clemson University,1969,1155,30913,3704,7013,1582,2807,0,8,3704,7005,3455,5525,8980,1025,723,1335,1133,3040,8990
Dale Ellis,201,92,University of Tennessee,1960,1235,35707,7504,15659,2681,3423,1801,4494,5703,11165,1506,2674,4180,1799,995,182,1794,2519,19490
Dale Wilkinson,208,99,Idaho State University,1960,24,90,8,32,12,14,0,2,8,30,2,6,8,4,0,0,8,20,28
Dalibor Bagaric,216,115,NaN,1980,95,973,97,269,57,102,0,2,97,267,84,154,238,37,29,43,72,163,251
Dallas Comegys,206,92,DePaul University,1964,142,2241,322,704,212,311,0,3,322,701,166,286,452,95,78,133,201,335,856
Damian Jones,190,83,University of Houston,1976,10,85,8,16,3,10,0,0,8,16,9,14,23,0,1,4,6,15,19
Damian Lillard,190,88,Weber State University,1990,396,14399,2975,6914,1888,2154,1042,2817,1933,4097,217,1376,1593,2446,368,110,1097,850,8880
Damien Inglis,203,111,NaN,1995,20,156,13,37,7,8,3,13,10,24,2,29,31,10,6,3,11,11,36
Damien Wilkins,208,99,Idaho State University,1960,563,10839,1331,3118,708,904,201,609,1130,2509,436,910,1346,787,429,129,519,938,3571
Damion James,201,102,University of Texas at Austin,1987,39,623,61,147,28,42,0,6,61,141,25,106,131,26,23,20,38,56,150
Damir Markota,208,102,NaN,1985,30,170,19,52,7,11,6,16,13,36,11,20,31,6,3,1,15,22,51
Damjan Rudez,208,103,NaN,1986,146,1638,175,413,24,31,106,284,69,129,18,74,92,84,31,7,69,143,480
Damon Jones,190,83,University of Houston,1976,736,14417,1640,4057,397,548,1007,2590,633,1467,133,1040,1173,1944,288,21,608,745,4684
Damon Stoudamire,178,77,University of Arizona,1973,1009,32982,4897,12090,2134,2565,1377,3917,3520,8173,810,2645,3455,6116,1096,90,2342,1931,13305
Damone Brown,188,79,Humboldt State University,1923,39,351,43,128,18,27,4,14,39,114,18,34,52,19,5,7,31,44,108
Dan Dickau,183,86,Gonzaga University,1978,414,7001,951,2371,551,663,274,800,677,1571,116,495,611,1137,257,15,495,759,2727
Dan Gadzuric,211,108,"University of California, Los Angeles",1978,569,8256,1103,2229,377,764,0,9,1103,2220,981,1480,2461,210,255,477,386,1341,2583
Dan Godfread,208,113,University of Evansville,1967,11,22,5,12,3,4,0,1,5,11,0,2,2,0,1,4,0,5,13
Dan Issel*,206,106,University of Kentucky,1948,77,1684,363,791,257,319,1,7,362,784,80,251,331,137,65,31,93,171,984
Dan Langhi,211,99,Vanderbilt University,1977,139,1290,177,454,40,64,12,40,165,414,54,149,203,39,30,12,37,113,406
Dan Majerle,198,97,Central Michigan University,1965,955,30206,3950,9171,1665,2246,1360,3798,2590,5373,1125,3140,4265,2755,1194,360,1116,1927,10925
Dan McClintock,213,122,Northern Arizona University,1977,6,58,9,18,0,5,0,0,9,18,10,7,17,1,0,2,3,11,18
Dan O'Sullivan,208,113,Fordham University,1968,51,314,30,73,29,39,0,1,30,72,24,47,71,11,5,5,12,49,89
Dan Roundfield,203,92,Central Michigan University,1953,171,4482,648,1385,469,612,1,13,647,1372,449,816,1265,308,73,121,359,418,1766
Dana Barros,180,73,Boston College,1967,850,19480,3281,7140,1249,1456,1090,2652,2191,4488,232,1377,1609,2837,740,46,1213,1074,8901
Dane Suttle,190,86,Pepperdine University,1961,6,24,6,13,2,2,0,1,6,12,0,3,3,2,1,0,1,3,14
Daniel Ewing,190,83,Duke University,1983,127,1683,162,416,71,91,36,122,126,294,32,126,158,174,69,10,107,148,431
Daniel Gibson,188,86,University of Texas at Austin,1986,397,9316,1065,2646,407,522,578,1419,487,1227,142,650,792,775,243,86,373,811,3115
Daniel Ochefu,211,111,Villanova University,1993,19,75,12,27,0,2,0,0,12,27,5,17,22,3,2,0,3,17,24
Daniel Orton,208,115,University of Kentucky,1990,51,542,50,103,43,72,0,1,50,102,48,78,126,24,18,28,29,81,143
Daniel Santiago,216,116,Saint Vincent College,1976,122,1418,153,326,111,162,0,0,153,326,76,184,260,38,39,47,85,231,417
Danilo Gallinari,208,102,NaN,1988,522,16426,2385,5687,2314,2683,939,2555,1446,3132,411,2046,2457,1003,426,229,685,1017,8023
Danny Ainge,193,79,Brigham Young University,1959,911,26366,4521,9654,1707,2002,1102,2888,3419,6766,629,2008,2637,4101,1039,127,1490,2247,11851
Danny Ferry,208,104,Duke University,1966,917,18133,2505,5615,752,895,677,1724,1828,3891,647,1903,2550,1185,384,292,811,1964,6439
Danny Fortson,201,117,University of Cincinnati,1976,440,8832,1196,2534,1221,1556,2,12,1194,2522,1195,1989,3184,301,182,94,655,1553,3615
Danny Granger,206,100,University of New Mexico,1983,627,19334,3448,7979,2248,2644,1049,2772,2399,5207,705,2316,3021,1138,573,498,1144,1690,10193
Danny Green,206,100,"University of California, Los Angeles",1957,470,11762,1467,3467,372,453,849,2123,618,1344,259,1344,1603,761,474,374,491,778,4155
Danny Manning,208,104,University of Kansas,1966,951,26722,5612,11036,2502,3461,44,216,5568,10820,1654,3426,5080,2324,1099,834,2086,3155,13770
Danny Schayes,211,106,Syracuse University,1959,928,17011,2245,4668,2234,2741,4,26,2241,4642,1374,2881,4255,870,438,620,1072,2614,6728
Danny Vranes,201,95,University of Utah,1958,271,5321,429,945,142,282,2,16,427,929,365,615,980,286,201,146,228,701,1002
Danny Young,190,79,Wake Forest University,1962,636,10559,1084,2508,517,618,217,664,867,1844,184,600,784,1846,553,41,519,589,2902
Dante Cunningham,203,104,Villanova University,1987,656,14022,1751,3727,373,567,129,406,1622,3321,774,1693,2467,450,447,336,348,1222,4004
Dante Exum,198,86,NaN,1995,148,3045,300,779,78,105,127,413,173,366,57,206,263,310,62,26,198,293,805
Danuel House,201,93,Texas A&M University,1993,1,1,0,0,0,0,0,0,0,0,0,1,1,0,0,0,0,0,0
Darington Hobson,201,95,University of New Mexico,1987,5,39,2,13,0,0,0,6,2,7,0,3,3,6,0,0,2,1,4
Dario Saric,208,101,NaN,1994,81,2129,381,927,172,220,106,341,275,586,112,401,513,182,57,30,183,162,1040
Darius Johnson-Odom,201,95,Syracuse University,1970,7,21,0,11,0,2,0,4,0,7,1,5,6,2,1,0,2,3,0
Darius Miles,206,95,NaN,1981,525,13809,2239,4726,861,1443,29,171,2210,4555,687,1862,2549,1002,451,556,1022,1191,5368
Darius Miller,203,106,University of Kentucky,1990,102,1460,118,281,37,44,47,134,71,147,17,114,131,89,42,21,46,185,320
Darius Morris,193,86,University of Michigan,1991,159,1777,205,528,68,107,59,184,146,344,47,105,152,233,58,2,139,160,537
Darius Songaila,206,112,Wake Forest University,1978,495,9229,1449,2904,514,609,3,19,1446,2885,553,1136,1689,589,324,106,486,1197,3415
Darius Washington,188,88,University of Memphis,1985,18,146,21,48,7,13,4,12,17,36,4,16,20,15,5,0,14,16,53
Darko Milicic,213,113,NaN,1985,555,10090,1415,3040,464,812,0,9,1415,3031,719,1554,2273,493,242,724,659,1239,3294
Darnell Jackson,206,114,University of Kansas,1985,166,1162,132,304,62,96,5,21,127,283,99,126,225,30,26,15,63,180,331
Darnell Mee,196,79,Western Kentucky University,1971,40,293,29,93,12,27,6,27,23,66,17,19,36,18,16,13,18,34,76
Darnell Valentine,185,83,University of Kansas,1959,485,11034,1507,3474,988,1260,45,158,1462,3316,252,798,1050,2368,680,46,948,976,4047
Darrell Armstrong,183,77,Fayetteville State University,1968,906,20903,2752,6784,1521,1747,951,2874,1801,3910,689,1695,2384,3572,1178,106,1623,1490,7976
Darrell Arthur,206,106,University of Kansas,1988,484,8804,1359,3063,357,466,153,435,1206,2628,544,1209,1753,400,301,304,407,1212,3228
Darrell Griffith,193,86,University of Louisville,1958,445,10502,2383,5355,651,907,376,1108,2007,4247,378,906,1284,693,478,112,713,871,5793
Darrell Walker,193,81,University of Arkansas,1961,675,17788,2287,5260,1249,1790,2,88,2285,5172,1005,2020,3025,3045,996,212,1292,1688,5825
Darren Collison,183,79,"University of California, Los Angeles",1987,563,16635,2646,5640,1397,1639,460,1211,2186,4429,259,1217,1476,2716,617,82,1171,947,7149
Darren Daye,203,99,"University of California, Los Angeles",1960,315,4765,770,1524,464,703,2,11,768,1513,268,513,781,572,178,48,390,553,2006
Darren Morningstar,208,106,University of Pittsburgh,1969,46,734,78,164,36,60,0,0,78,164,62,100,162,30,28,4,38,140,192
Darrick Martin,180,77,"University of California, Los Angeles",1971,573,10314,1333,3470,904,1072,370,1099,963,2371,117,553,670,1692,393,25,738,1017,3940
Darrin Hancock,201,92,University of Kansas,1971,157,1528,212,405,83,140,2,6,210,399,62,125,187,101,65,11,108,172,509
Darrun Hilliard,198,92,Villanova University,1993,77,764,99,257,50,68,31,96,68,161,7,71,78,60,20,3,47,67,279
Darryl Dawkins,211,113,NaN,1957,122,2399,509,849,391,570,0,2,509,847,156,312,468,129,32,102,250,464,1409
Darryl Johnson,201,95,Syracuse University,1970,11,28,5,12,2,2,0,1,5,11,2,0,2,1,0,0,1,3,12
Darryl Watkins,211,117,Syracuse University,1984,14,169,12,29,11,23,0,0,12,29,13,26,39,3,7,6,15,22,35
Darvin Ham,201,99,Texas Tech University,1973,453,5496,476,918,266,539,4,16,472,902,501,518,1019,243,145,162,330,823,1222
Darwin Cook,190,83,University of Portland,1958,351,6734,1180,2658,339,424,31,181,1149,2477,186,442,628,955,470,69,479,646,2730
Dave Corzine,211,113,DePaul University,1956,426,10095,1400,2928,570,773,6,35,1394,2893,740,1548,2288,762,170,349,554,832,3376
Dave Feitl,211,106,University of Texas at El Paso,1962,275,3001,471,1089,250,333,0,9,471,1080,241,574,815,125,46,46,234,439,1192
Dave Greenwood,206,100,"University of California, Los Angeles",1957,487,11285,1278,2714,882,1171,3,12,1275,2702,972,2133,3105,758,302,280,680,1393,3441
Dave Henderson,196,88,Duke University,1964,22,351,47,116,32,47,0,1,47,115,11,24,35,34,12,5,40,41,126
Dave Hoppen,211,106,University of Nebraska,1964,238,3198,434,856,254,329,1,8,433,848,296,564,860,135,59,36,188,505,1123
Dave Jamerson,196,86,Ohio University,1967,95,608,122,318,51,60,13,47,109,271,31,50,81,62,23,1,46,63,308
Dave Johnson,201,95,Syracuse University,1970,59,475,74,203,53,80,3,15,71,188,27,37,64,17,12,1,37,30,204
Dave Popson,208,99,University of North Carolina,1964,58,302,48,119,14,20,0,1,48,118,33,40,73,21,5,9,30,51,110
David Andersen,208,104,Augsburg College,1943,143,1637,259,582,74,111,43,124,216,458,94,282,376,70,25,30,81,199,635
David Benoit,203,99,University of Alabama,1968,569,10437,1487,3459,635,796,266,831,1221,2628,636,1550,2186,312,251,266,476,1178,3875
David Cooke,203,104,Saint Mary's College of California,1963,6,38,2,11,5,10,0,0,2,11,5,5,10,1,4,0,2,5,9
David Harrison,213,127,University of Colorado,1982,189,2686,374,706,201,383,0,0,374,706,184,365,549,47,64,185,216,538,949
David Lee,201,102,University of San Francisco,1942,884,25196,4765,8901,2128,2759,1,30,4764,8871,2250,5374,7624,1909,647,357,1520,2284,11659
David Noel,198,104,University of North Carolina,1984,68,792,65,177,37,43,17,53,48,124,42,81,123,65,25,9,40,77,184
David Nwaba,193,94,"California Polytechnic State University, San L...",1993,20,397,47,81,25,39,1,5,46,76,16,46,62,14,13,7,11,36,120
David Pope,201,99,Norfolk State University,1962,33,203,26,73,9,17,1,2,25,71,15,14,29,9,5,4,9,41,62
David Rivers,183,77,University of Notre Dame,1965,114,1286,139,349,104,131,1,12,138,337,53,94,147,282,61,10,166,117,383
David Robinson*,216,106,United States Naval Academy,1965,987,34271,7365,14221,6035,8201,25,100,7340,14121,3083,7414,10497,2441,1388,2954,2417,2835,20790
David Stockton,180,74,Gonzaga University,1991,3,33,2,6,3,6,1,2,1,4,0,2,2,9,2,0,4,1,8
David Thirdkill,201,88,Bradley University,1960,102,840,104,210,82,142,0,4,104,206,52,71,123,25,23,9,52,111,290
David Vanterpool,196,90,St. Bonaventure University,1973,22,411,46,110,30,50,0,6,46,104,15,22,37,66,23,3,37,44,122
David Vaughn,211,99,Oral Roberts University,1952,158,1645,203,472,97,152,0,3,203,469,187,326,513,56,46,58,138,299,503
David Wear,208,104,"University of California, Los Angeles",1990,2,7,0,2,0,0,0,1,0,1,2,0,2,1,0,0,0,1,0
David Wesley,183,86,Baylor University,1970,1029,33046,4582,10863,2385,3016,1241,3366,3341,7497,564,2069,2633,4424,1376,170,1921,2525,12790
David West,206,113,Xavier University,1980,961,28145,5487,11141,2511,3069,54,207,5433,10934,1720,4632,6352,2135,717,775,1580,2288,13539
David Wingate,196,83,Georgetown University,1963,740,13243,1690,3798,707,958,79,290,1611,3508,445,975,1420,1376,597,122,853,1249,4166
David Wood,206,102,"University of Nevada, Reno",1964,474,6323,642,1437,395,505,131,390,511,1047,439,719,1158,325,183,86,260,1083,1810
Davis Bertans,208,95,NaN,1992,67,808,103,234,28,34,69,173,34,61,22,77,99,46,20,28,32,75,303
DeAndre Jordan,211,120,Texas A&M University,1988,673,18621,2487,3674,1176,2733,1,11,2486,3663,2105,4712,6817,440,410,1207,846,1812,6151
DeAndre Liggins,198,94,University of Kentucky,1988,181,1960,144,357,68,117,41,115,103,242,60,225,285,128,118,31,108,201,397
DeAndre' Bembry,198,95,Saint Joseph's University,1994,38,371,47,98,6,16,1,18,46,80,14,45,59,28,8,5,16,21,101
DeJuan Blair,201,122,University of Pittsburgh,1989,424,7054,1242,2371,381,627,0,9,1242,2362,810,1343,2153,349,316,127,471,1003,2865
DeJuan Wheat,183,74,University of Louisville,1973,80,740,93,243,49,70,30,77,63,166,14,42,56,127,32,3,57,71,265
DeMar DeRozan,201,100,University of Southern California,1989,595,20275,4071,9119,3078,3718,236,841,3835,8278,455,1969,2424,1661,570,163,1148,1348,11456
DeMarco Johnson,193,83,Pepperdine University,1954,5,37,3,9,0,0,0,0,3,9,3,4,7,0,1,0,3,5,6
DeMarcus Cousins,211,122,University of Kentucky,1990,559,18035,4346,9494,3215,4337,343,1007,4003,8487,1571,4496,6067,1800,786,668,1955,2161,12250
DeMarcus Nelson,193,90,Duke University,1985,13,171,24,54,5,14,0,3,24,51,6,18,24,13,9,2,15,24,53
DeMarre Carroll,203,97,University of Missouri,1986,450,9900,1276,2894,495,676,406,1124,870,1770,500,1132,1632,491,439,108,316,858,3453
DeQuan Jones,203,100,University of Miami,1990,63,803,95,218,34,51,9,35,86,183,17,88,105,16,19,22,30,55,233
DeSagana Diop,213,136,NaN,1982,755,10734,671,1528,238,517,1,6,670,1522,1108,1776,2884,342,282,774,452,1493,1581
DeShawn Stevenson,196,95,NaN,1981,968,21723,2660,6549,1067,1535,588,1775,2072,4774,500,1721,2221,1569,491,157,964,1354,6975
Dean Garrett,208,102,Indiana University,1966,393,7152,740,1559,293,436,0,0,740,1559,613,1254,1867,209,175,382,213,719,1773
Dean Oliver,180,81,University of Iowa,1978,35,232,24,75,13,17,3,19,21,56,8,16,24,44,10,0,21,25,64
Dedric Willoughby,190,81,Iowa State University,1974,25,508,61,179,39,51,29,98,32,81,11,40,51,66,23,2,37,32,190
Dee Brown,185,72,Jacksonville University,1968,767,19534,2854,6580,1161,1418,733,2044,2121,4536,365,1454,1819,2536,924,235,1043,1494,7602
Dejounte Murray,196,77,University of Washington,1996,38,322,50,116,21,30,9,23,41,93,6,36,42,48,8,6,38,29,130
Delaney Rudd,188,81,Wake Forest University,1962,239,2357,317,768,137,180,45,175,272,593,45,139,184,519,74,4,250,244,816
Dell Curry,193,86,Virginia Polytechnic Institute and State Unive...,1964,1083,23549,5090,11146,1245,1476,1245,3098,3845,8048,599,2018,2617,1909,985,238,1299,1795,12670
Dell Demps,190,92,University of the Pacific,1970,20,108,21,42,16,21,1,3,20,39,2,7,9,9,6,1,13,12,59
Delon Wright,196,83,University of Utah,1992,54,675,85,196,68,90,15,43,70,153,24,61,85,88,35,14,41,38,253
Delonte West,193,81,Saint Joseph's University,1983,493,13375,1797,4046,687,842,424,1147,1373,2899,244,1214,1458,1769,524,208,819,931,4705
Demetris Nichols,203,97,Syracuse University,1984,36,116,18,64,2,4,6,30,12,34,0,14,14,4,0,8,8,10,44
Demetrius Calip,185,74,University of Michigan,1969,7,58,4,18,2,3,1,5,3,13,1,4,5,12,1,0,5,8,11
Demetrius Jackson,185,91,University of Notre Dame,1994,5,17,3,4,3,6,1,1,2,3,2,2,4,3,0,0,0,0,10
Deng Gai,206,113,Fairfield University,1982,2,5,0,0,0,0,0,0,0,0,0,0,0,0,0,0,0,0,0
Dennis Hopson,196,90,Ohio State University,1965,405,8823,1651,3786,1001,1327,73,272,1578,3514,526,619,1145,641,386,198,648,787,4376
Dennis Horner,206,104,North Carolina State University,1988,8,22,1,4,3,4,0,1,1,3,2,3,5,0,0,0,1,1,5
Dennis Johnson*,193,83,Pepperdine University,1954,461,15656,2233,4995,1246,1487,40,250,2193,4745,346,1131,1477,3148,561,176,1049,1225,5752
Dennis Nutt,188,77,Texas Christian University,1963,25,91,16,40,20,22,5,17,11,23,1,7,8,16,7,0,10,6,57
Dennis Rodman*,201,95,Southeastern Oklahoma State University,1961,911,28839,2766,5310,1069,1832,82,355,2684,4955,4329,7625,11954,1600,611,531,1484,2843,6683
Dennis Schroder,185,78,NaN,1993,285,6263,1233,2849,539,659,239,723,994,2126,101,575,676,1258,210,29,652,468,3244
Dennis Scott,203,103,Georgia Institute of Technology,1968,746,21011,3378,8152,1084,1367,1376,3499,2002,4653,422,1657,2079,1489,593,239,891,1476,9216
Denzel Valentine,198,96,Michigan State University,1993,57,976,102,288,14,18,73,208,29,80,11,140,151,63,30,7,49,86,291
DerMarr Johnson,193,83,Pepperdine University,1954,344,5930,770,1872,307,389,274,815,496,1057,192,577,769,304,198,149,349,598,2121
Derek Anderson,196,87,University of Kentucky,1974,658,19022,2527,6225,1967,2309,685,2025,1842,4200,461,1670,2131,2184,714,93,1106,1328,7706
Derek Fisher,185,90,University of Arkansas at Little Rock,1974,1383,34802,3904,9838,2117,2584,1313,3530,2591,6308,428,2388,2816,4021,1422,105,1576,2856,11238
Derek Grimm,206,104,University of Missouri,1974,9,34,4,14,2,2,4,12,0,2,0,4,4,0,3,1,3,6,14
Derek Harper,193,83,University of Illinois at Urbana-Champaign,1961,1199,38278,6294,13677,2600,3491,1140,3203,5154,10474,663,2190,2853,6672,1987,291,2358,2775,16328
Derek Hood,203,100,University of Arkansas,1976,2,4,0,3,0,0,0,0,0,3,0,1,1,0,0,0,0,0,0
Derek Smith,190,81,University of Utah,1920,385,9669,1988,4083,1114,1495,51,176,1937,3907,473,786,1259,910,275,172,699,1173,5141
Derek Strong,203,99,Xavier University,1968,456,8548,1067,2483,943,1199,11,61,1056,2422,783,1430,2213,291,203,94,421,740,3088
Deron Williams,190,90,University of Illinois at Urbana-Champaign,1984,974,32987,5565,12539,3316,4023,1368,3847,4197,8692,407,2619,3026,7846,977,229,2770,2460,15814
Derrick Alston,211,102,Duquesne University,1972,139,2657,318,650,114,234,1,7,317,643,228,297,525,94,95,87,112,298,751
Derrick Brown,185,72,Jacksonville University,1968,220,3130,428,818,206,333,18,51,410,767,208,304,512,152,109,42,144,267,1080
Derrick Byars,201,99,Vanderbilt University,1984,2,37,3,11,4,4,0,6,3,5,6,5,11,1,2,0,0,2,10
Derrick Caracter,206,124,University of Texas at El Paso,1988,41,215,32,66,17,23,0,0,32,66,19,24,43,7,4,10,19,47,81
Derrick Chievous,201,88,University of Missouri,1967,209,2831,504,1120,360,482,11,42,493,1078,195,259,454,141,103,22,232,317,1379
Derrick Coleman,208,104,Syracuse University,1967,781,25903,4616,10335,3326,4326,326,1105,4290,9230,2079,5153,7232,1985,606,1051,2036,2062,12884
Derrick Dial,193,83,Eastern Michigan University,1975,114,986,144,397,57,82,9,53,135,344,59,130,189,98,31,15,51,64,354
Derrick Favors,208,120,Georgia Institute of Technology,1991,557,13883,2419,4738,1170,1779,4,26,2415,4712,1340,2507,3847,549,417,693,800,1583,6012
Derrick Gervin,203,90,University of Texas at San Antonio,1963,77,1082,257,591,155,203,7,31,250,560,69,106,175,38,39,26,57,135,676
Derrick Jones,203,100,University of Miami,1990,32,545,68,121,29,41,3,11,65,110,39,40,79,12,14,13,13,63,168
Derrick McKey,206,92,University of Alabama,1966,937,27229,3908,8048,2247,2885,203,642,3705,7406,1515,2872,4387,2254,1072,611,1713,2700,10266
Derrick Phelps,193,82,University of North Carolina,1972,3,5,0,1,0,2,0,0,0,1,0,0,0,1,0,0,0,3,0
Derrick Rose,190,86,University of Memphis,1988,470,16292,3562,7897,1668,2033,363,1218,3199,6679,424,1311,1735,2799,372,172,1333,655,9155
Derrick Rowland,196,88,State University of New York at Potsdam,1959,2,9,1,3,1,2,0,0,1,3,0,1,1,1,0,0,0,1,3
Derrick Williams,190,90,University of Illinois at Urbana-Champaign,1984,554,11479,1642,3786,1144,1615,307,1032,1335,2754,441,1704,2145,377,261,135,503,706,4735
Derrick Zimmerman,190,88,Mississippi State University,1981,2,32,2,3,0,0,0,0,2,3,1,3,4,7,0,0,4,4,4
Desmon Farmer,196,99,University of Southern California,1981,11,86,9,29,3,3,5,20,4,9,0,7,7,11,1,0,5,8,26
Desmond Ferguson,201,92,University of Detroit Mercy,1977,7,32,5,12,0,2,3,8,2,4,0,4,4,1,0,0,1,0,13
Desmond Mason,201,101,Oklahoma State University,1977,723,22404,3388,7552,2051,2768,87,326,3301,7226,958,2428,3386,1212,508,262,1147,1642,8914
Desmond Penigar,201,111,Utah State University,1981,10,89,14,28,4,4,0,0,14,28,6,18,24,3,2,2,6,14,32
Detlef Schrempf,206,97,University of Washington,1963,1205,35447,5674,11573,4759,5935,482,1271,5192,10302,1997,5421,7418,4012,909,331,2401,3580,16589
Devean George,203,99,Augsburg College,1977,630,11682,1318,3360,473,656,427,1246,891,2114,546,1429,1975,543,436,230,447,1270,3536
Devin Booker,198,93,University of Kentucky,1996,154,4838,973,2298,582,697,246,694,727,1604,73,363,436,468,116,41,401,467,2774
Devin Brown,185,72,Jacksonville University,1968,525,10175,1322,3323,779,1001,358,1053,964,2270,373,1057,1430,751,300,65,576,833,3781
Devin Durrant,201,90,Brigham Young University,1960,63,807,122,295,73,106,0,3,122,292,51,81,132,85,22,10,81,116,317
Devin Ebanks,206,97,West Virginia University,1989,63,711,82,213,52,72,8,36,74,177,51,71,122,24,18,12,35,56,224
Devin Gray,201,108,Clemson University,1972,33,222,31,89,23,39,0,0,31,89,23,30,53,9,13,3,14,44,85
Devin Green,201,95,Hampton University,1982,27,135,6,28,13,21,0,2,6,26,10,14,24,7,3,0,5,13,25
Devin Harris,190,87,University of Wisconsin,1983,981,25828,3831,8777,3132,3906,805,2478,3026,6299,311,1943,2254,4467,1076,183,1918,2233,11599
Devyn Marble,198,90,University of Iowa,1992,44,457,35,115,15,40,12,54,23,61,11,58,69,29,22,3,16,39,97
Dewayne Dedmon,213,111,University of Southern California,1989,255,3660,427,764,198,297,0,1,427,763,390,882,1272,76,89,201,180,562,1052
Dexter Boney,193,83,"University of Nevada, Las Vegas",1970,8,48,6,19,6,8,1,6,5,13,3,3,6,0,2,1,1,3,19
Dexter Cambridge,201,101,University of Texas at Austin,1970,53,885,151,312,68,99,0,4,151,308,88,79,167,58,24,6,63,128,370
Dexter Pittman,211,139,University of Texas at Austin,1988,61,379,53,120,18,36,0,0,53,120,45,56,101,9,8,8,25,91,124
Dexter Shouse,188,90,University of South Alabama,1963,3,18,0,4,0,0,0,1,0,3,0,0,0,2,1,1,2,2,0
Deyonta Davis,211,107,Michigan State University,1996,36,238,24,47,10,18,0,0,24,47,20,40,60,2,3,17,8,40,58
Diamond Stone,211,115,University of Maryland,1997,7,24,3,13,4,4,0,0,3,13,1,5,6,0,0,1,2,5,10
Diante Garrett,190,83,Southern Illinois University,1947,90,1197,117,314,15,22,39,111,78,203,16,96,112,151,51,5,91,80,288
Dickey Simpkins,206,112,Providence College,1972,367,5634,543,1213,432,711,2,11,541,1202,450,814,1264,338,100,65,400,647,1520
Didier Ilunga-Mbenga,198,97,NaN,1984,276,1892,219,467,59,101,0,2,219,465,157,266,423,51,44,167,99,356,497
Dijon Thompson,201,88,"University of California, Los Angeles",1983,16,93,17,40,7,8,4,13,13,27,7,12,19,3,3,1,3,8,45
Dikembe Mutombo*,218,111,Georgetown University,1966,1271,39382,4438,8601,3602,5251,0,2,4438,8599,4115,9259,13374,1316,523,3492,2317,3587,12478
Dino Radja,211,102,NaN,1967,224,7308,1516,3052,701,954,0,3,1516,3049,497,1386,1883,356,201,282,495,745,3733
Dion Glover,196,103,Georgia Institute of Technology,1978,363,7775,1144,2811,551,726,188,586,956,2225,271,892,1163,585,283,84,472,610,3027
Dion Waiters,193,102,Syracuse University,1991,415,11780,2079,5069,748,1076,472,1400,1607,3669,190,894,1084,1072,424,110,724,814,5378
Dionte Christmas,196,92,Temple University,1986,31,198,22,62,18,24,9,31,13,31,13,25,38,8,2,3,6,19,71
Dirk Minniefield,190,81,University of Kentucky,1961,368,6471,819,1753,279,383,40,147,779,1606,161,442,603,1421,327,21,608,779,1957
Dirk Nowitzki,213,111,NaN,1978,1394,48673,10688,22600,7104,8081,1780,4668,8908,17932,1441,9452,10893,3496,1158,1218,2425,3379,30260
Doc Rivers,193,83,Marquette University,1961,846,22618,3153,7177,2231,2850,404,1216,2749,5961,577,1937,2514,4737,1501,342,1537,2524,8941
Domantas Sabonis,211,108,Gonzaga University,1996,81,1632,192,481,44,67,51,159,141,322,45,242,287,82,39,32,83,200,479
Dominic McGuire,206,99,"California State University, Fresno",1985,419,6042,431,1035,163,260,3,16,428,1019,386,940,1326,453,172,199,271,575,1028
Dominic Pressley,188,77,Boston College,1964,26,248,18,62,10,18,0,4,18,58,6,24,30,52,8,0,22,22,46
Dominique Jones,203,99,Mississippi State University,1975,80,741,83,227,78,107,2,21,81,206,33,81,114,144,29,10,76,64,246
Dominique Wilkins*,201,90,University of Georgia,1960,985,35090,9376,20528,5861,7127,794,2504,8582,18024,2652,3938,6590,2591,1269,522,2446,1780,25407
Don Buse,193,86,University of Evansville,1950,65,939,82,203,23,30,31,87,51,116,21,40,61,203,38,1,45,75,218
Don Collins,198,81,Illinois State University,1951,17,148,22,62,13,16,0,0,22,62,21,13,34,9,9,5,13,16,57
Don MacLean,208,106,"University of California, Los Angeles",1970,319,6679,1320,2902,794,1038,56,197,1264,2705,356,854,1210,404,118,51,398,598,3490
Don Reid,203,113,Georgetown University,1973,441,5872,643,1211,312,472,0,1,643,1210,468,803,1271,154,206,313,276,1253,1598
Donald Hodge,213,104,Temple University,1969,264,3616,471,1081,254,357,4,14,467,1067,315,517,832,195,85,103,238,557,1200
Donald Royal,203,95,University of Notre Dame,1966,597,9623,1051,2251,1356,1752,0,16,1051,2235,624,1002,1626,542,277,111,600,1003,3458
Donald Sloan,190,92,Texas A&M University,1988,274,4681,555,1374,236,311,107,360,448,1014,75,475,550,794,101,11,293,247,1453
Donald Whiteside,178,72,Northern Illinois University,1969,30,275,19,57,11,17,12,37,7,20,2,11,13,37,11,0,18,23,61
Donatas Motiejunas,213,100,NaN,1990,248,4553,728,1552,249,415,121,404,607,1148,296,653,949,270,118,81,284,532,1826
Donell Taylor,198,81,University of Alabama at Birmingham,1982,98,834,109,276,41,64,7,34,102,242,30,76,106,90,47,7,59,81,266
Donnell Harvey,203,99,University of Florida,1980,312,4942,650,1403,358,542,1,13,649,1390,389,829,1218,219,142,131,287,708,1659
Donnie Boyce,196,88,University of Colorado,1973,30,195,30,86,13,26,6,24,24,62,12,13,25,16,13,5,22,19,79
Donny Marshall,206,98,University of Connecticut,1973,119,919,87,271,77,113,42,125,45,146,39,82,121,36,37,5,45,107,293
Donta Smith,188,86,University of Minnesota,1920,61,560,59,140,39,60,8,26,51,114,22,44,66,48,31,5,29,70,165
Dontae' Jones,203,99,Mississippi State University,1975,15,91,19,57,0,0,6,23,13,34,3,6,9,5,2,3,11,12,44
Donte Greene,211,102,Syracuse University,1988,253,4259,585,1441,206,294,165,542,420,899,140,460,600,183,111,116,222,373,1541
Dontell Jefferson,196,88,University of Arkansas,1983,6,84,11,22,6,9,1,2,10,20,1,11,12,9,4,1,6,9,29
Dontonio Wingfield,203,116,University of Cincinnati,1974,114,1146,157,404,62,86,47,152,110,252,121,154,275,76,39,15,89,191,423
Donyell Marshall,206,98,University of Connecticut,1973,1137,30441,4943,11404,1922,2645,1117,3199,3826,8205,2269,5396,7665,1542,934,1076,1539,2608,12925
Dorell Wright,206,92,NaN,1985,549,12280,1657,3908,666,826,617,1691,1040,2217,375,1718,2093,850,418,271,475,790,4597
Dorian Finney-Smith,203,99,University of Florida,1993,81,1642,124,333,46,61,56,191,68,142,55,166,221,67,52,25,45,125,350
Doron Lamb,193,95,University of Kentucky,1991,147,1849,183,486,69,104,64,164,119,322,24,117,141,107,37,1,79,158,499
Doug Christie,198,90,Pepperdine University,1970,934,28640,3518,8273,2159,2631,866,2440,2652,5833,869,2844,3713,3308,1705,429,1920,2298,10061
Doug Edwards,201,99,Florida State University,1971,85,838,71,188,61,86,0,6,71,182,61,92,153,60,17,27,57,90,203
Doug Lee,196,90,Purdue University,1964,73,415,61,148,28,40,18,58,43,90,17,25,42,32,17,5,20,64,168
Doug McDermott,203,102,Creighton University,1992,249,5198,778,1745,224,267,277,714,501,1031,83,513,596,181,44,17,146,314,2057
Doug Overton,190,86,La Salle University,1969,605,9027,1067,2602,436,539,124,405,943,2197,167,633,800,1271,241,22,582,726,2694
Doug Roth,211,115,University of Tennessee,1967,42,412,37,86,7,14,0,1,37,85,44,76,120,20,8,13,16,70,81
Doug Smith,188,86,University of Minnesota,1920,296,5833,1020,2399,313,405,3,36,1017,2363,394,840,1234,400,224,150,353,979,2356
Doug West,198,90,Villanova University,1967,676,16649,2631,5473,1178,1470,37,194,2594,5279,532,1138,1670,1292,459,189,823,1862,6477
Dragan Bender,216,102,NaN,1997,43,574,57,161,4,11,28,101,29,60,23,80,103,23,10,22,32,74,146
Dragan Tarlac,208,117,NaN,1973,43,598,39,99,25,33,0,0,39,99,37,85,122,31,7,19,38,95,103
Draymond Green,201,104,Michigan State University,1990,397,10627,1283,2950,639,920,361,1082,922,1868,490,2194,2684,1627,540,415,718,1100,3566
Drazen Petrovic*,196,88,NaN,1964,351,8684,1948,3862,910,1083,278,648,1670,3214,291,488,779,787,308,28,677,883,5084
Drew Barry,196,86,Georgia Institute of Technology,1973,76,757,58,136,28,36,31,81,27,55,8,71,79,144,21,2,68,98,175
Drew Gooden,208,113,University of Kansas,1981,1050,27141,4644,10060,2331,3038,103,408,4541,9652,2536,5031,7567,1155,716,638,1614,2670,11722
Drew Gordon,206,111,University of New Mexico,1990,9,71,8,19,1,2,0,3,8,16,7,11,18,2,1,0,8,7,17
Duane Causwell,213,108,Temple University,1968,541,9409,1029,2029,588,952,2,7,1027,2022,794,1479,2273,243,220,767,500,1471,2648
Duane Cooper,185,83,University of Southern California,1969,88,781,80,199,36,50,8,37,72,162,15,44,59,178,21,2,89,78,204
Duane Ferrell,201,94,Georgia Institute of Technology,1965,583,8734,1420,2961,822,1096,42,146,1378,2815,552,580,1132,509,302,105,509,902,3704
Duane Washington,193,88,Middle Tennessee State University,1964,19,184,18,47,16,20,2,4,16,43,5,19,24,39,13,0,11,25,54
Dudley Bradley,198,88,University of North Carolina,1957,379,6115,631,1537,289,403,132,417,499,1120,146,471,617,672,530,120,352,756,1683
Duje Dukan,206,99,University of Wisconsin,1991,1,24,2,10,0,0,2,5,0,5,2,2,4,1,1,0,0,2,6
Dwayne Jones,208,95,University of Houston,1952,82,636,33,65,41,83,0,1,33,64,86,105,191,12,11,29,26,112,107
Dwayne McClain,198,83,Villanova University,1963,45,461,69,180,18,35,1,9,68,171,14,16,30,67,38,4,40,61,157
Dwayne Morton,201,88,University of Louisville,1971,41,395,50,129,58,85,9,25,41,104,21,37,58,18,11,15,27,45,167
Dwayne Polee,196,81,Pepperdine University,1963,1,6,1,4,0,0,0,3,1,1,0,0,0,0,1,0,1,3,2
Dwayne Schintzius,216,117,University of Florida,1968,217,1950,256,633,74,116,1,8,255,625,167,369,536,93,30,117,119,321,587
Dwayne Whitfield,206,108,Jackson State University,1972,8,122,13,30,14,22,0,0,13,30,9,16,25,2,3,2,8,14,40
Dwight Buycks,190,86,Marquette University,1989,20,269,33,88,17,19,12,28,21,60,6,29,35,24,11,0,22,14,95
Dwight Howard,211,120,NaN,1985,954,33291,5988,10237,4671,8255,5,56,5983,10181,3392,8697,12089,1426,931,1916,2835,3092,16652
Dwight Powell,211,108,Stanford University,1991,204,2797,402,807,262,349,29,112,373,695,213,466,679,111,115,75,96,333,1095
Dwyane Wade,193,99,Marquette University,1982,915,32352,7739,15975,5408,7041,431,1502,7308,14473,1140,3257,4397,5173,1500,800,3020,2086,21317
Dyron Nix,201,95,University of Tennessee,1967,20,109,14,39,11,16,0,0,14,39,8,18,26,5,3,1,7,15,39
E'Twaun Moore,208,102,NaN,1986,380,7106,1007,2314,197,263,278,753,729,1561,145,522,667,648,229,95,310,540,2489
Earl Barron,213,113,University of Memphis,1981,173,2449,305,837,145,212,3,18,302,819,242,387,629,79,59,42,134,340,758
Earl Boykins,165,61,Eastern Michigan University,1976,766,15477,2485,5944,1495,1704,490,1381,1995,4563,343,716,1059,2464,464,37,913,794,6955
Earl Clark,208,102,University of Louisville,1988,357,4862,618,1544,199,307,123,377,495,1167,254,768,1022,161,108,179,234,435,1558
Earl Cureton,206,95,University of Detroit Mercy,1957,488,11015,1357,2827,464,853,0,14,1357,2813,1090,1553,2643,664,262,312,604,1226,3178
Earl Jones,213,95,University of the District of Columbia,1961,14,50,5,13,3,4,0,0,5,13,4,6,10,4,0,1,8,13,13
Earl Watson,185,88,"University of California, Los Angeles",1979,948,21072,2331,5648,942,1344,612,1823,1719,3825,486,1657,2143,4160,941,186,1684,1914,6216
Ed Davis,208,108,University of North Carolina,1989,562,11667,1625,2910,651,1131,0,1,1625,2909,1248,2274,3522,462,293,535,440,1376,3901
Ed Gray,190,95,University of California,1975,60,809,130,384,83,102,30,88,100,296,16,57,73,46,27,12,59,103,373
Ed Horton,203,104,University of Iowa,1967,45,374,80,162,42,69,0,4,80,158,59,49,108,19,9,5,39,63,202
Ed Nealy,201,107,Kansas State University,1960,471,4755,382,843,202,296,46,159,336,684,376,858,1234,309,166,33,156,594,1012
Ed O'Bannon,203,100,"University of California, Los Angeles",1972,192,2871,342,958,139,178,46,196,296,762,165,299,464,141,102,35,102,289,869
Ed Pinckney,206,88,Villanova University,1963,947,19420,2405,4534,1964,2553,0,27,2405,4507,1842,3017,4859,917,759,529,1041,1889,6774
Ed Stokes,213,119,University of Arizona,1971,4,17,1,3,1,2,0,0,1,3,1,3,4,1,1,2,2,4,3
Eddie Basden,196,97,University of North Carolina at Charlotte,1983,19,141,15,37,8,10,1,7,14,30,7,21,28,8,9,2,9,17,39
Eddie Gill,183,86,Weber State University,1978,201,2187,191,527,159,186,68,212,123,315,29,200,229,239,111,16,148,227,609
Eddie Griffin,208,99,Seton Hall University,1982,303,6729,854,2263,226,337,237,752,617,1511,497,1247,1744,236,105,518,227,506,2171
Eddie House,185,81,Arizona State University,1978,853,14513,2416,5898,454,529,940,2420,1476,3478,193,1222,1415,1293,554,71,651,1073,6226
Eddie Hughes,178,74,Colorado State University,1960,97,1158,116,279,36,52,28,77,88,202,24,69,93,159,65,3,56,122,296
Eddie Johnson,203,92,Tennessee State University,1944,1333,34061,7811,16654,3387,4017,694,2041,7117,14613,1545,2898,4443,3439,707,148,2339,2965,19703
Eddie Jones,208,102,"University of Nevada, Reno",1956,1068,36253,5370,12303,3016,3740,1672,4511,3698,7792,842,3399,4241,3107,1813,648,1647,2735,15428
Eddie Lee,190,88,NaN,1962,322,3787,596,1267,342,606,0,9,596,1258,400,602,1002,62,82,60,288,609,1534
Eddie Robinson,203,95,University of Central Oklahoma,1976,278,5345,852,1681,226,306,8,32,844,1649,241,523,764,252,216,91,215,345,1938
Eddy Curry,213,133,NaN,1982,527,13109,2578,4734,1662,2588,2,2,2576,4732,947,1778,2725,287,155,384,1174,1562,6820
Edgar Jones,208,102,"University of Nevada, Reno",1956,141,2549,447,920,296,400,7,31,440,889,171,378,549,103,70,96,186,388,1197
Eduardo Najera,203,108,University of Oklahoma,1976,733,13083,1411,2973,606,911,135,439,1276,2534,1033,1632,2665,587,513,269,488,1620,3563
Edwin Ubiles,198,92,Siena College,1986,4,52,5,18,3,3,1,5,4,13,2,8,10,1,1,1,1,1,14
Edy Tavares,211,115,NaN,1997,4,56,8,10,0,6,0,0,8,10,8,14,22,2,0,12,4,6,16
Efthimi Rentzias,211,113,NaN,1976,35,144,20,59,8,9,4,8,16,51,10,16,26,7,6,2,4,21,52
Ekpe Udoh,208,108,Baylor University,1987,331,5854,536,1248,340,467,0,5,536,1243,461,653,1114,236,164,426,242,747,1412
Elden Campbell,211,97,Clemson University,1968,1189,28494,4440,9718,3002,4292,2,41,4438,9677,2081,4706,6787,1338,782,1721,1526,3351,11884
Eldridge Recasner,190,86,University of Washington,1967,302,5154,631,1484,236,266,239,585,392,899,131,403,534,527,130,12,306,407,1737
Elfrid Payton,193,83,University of Louisiana at Lafayette,1994,237,7046,1049,2350,376,615,81,280,968,2070,273,724,997,1530,319,80,558,529,2555
Elias Harris,203,108,Gonzaga University,1989,2,11,0,1,0,0,0,0,0,1,1,0,1,1,1,0,0,0,0
Elijah Millsap,198,102,University of Alabama at Birmingham,1987,69,1120,93,284,72,106,29,104,64,180,37,154,191,78,63,19,78,159,287
Elliot Perry,183,68,University of Memphis,1969,683,10727,1506,3317,658,850,150,420,1356,2897,215,646,861,1903,650,24,902,797,3820
Elliot Williams,196,86,University of Memphis,1989,122,1589,207,495,98,149,62,192,145,303,38,131,169,106,49,6,82,170,574
Elmer Bennett,183,77,University of Notre Dame,1970,30,234,22,66,20,28,6,20,16,46,1,13,14,33,13,1,30,23,70
Elmore Spencer,213,122,"University of Nevada, Las Vegas",1969,174,2699,394,767,149,256,0,3,394,764,130,438,568,110,53,172,255,348,937
Elston Turner,196,86,University of Mississippi,1959,319,5595,617,1402,147,207,4,30,613,1372,303,526,829,578,294,25,251,613,1385
Elton Brand,203,124,Duke University,1979,1058,34910,6599,13185,3627,4929,2,21,6597,13164,3304,5736,9040,2184,940,1828,2060,3115,16827
Emanual Davis,193,88,Delaware State University,1968,226,3934,402,1020,140,178,156,443,246,577,79,361,440,396,167,29,267,344,1100
Emeka Okafor,208,114,University of Connecticut,1982,590,18702,2956,5772,1344,2303,0,2,2956,5770,1907,3940,5847,512,406,978,971,1666,7256
Emmanuel Mudiay,196,90,NaN,1996,123,3474,537,1456,271,376,130,410,407,1046,61,349,410,589,106,48,340,236,1475
Enes Kanter,211,111,NaN,1992,520,11614,2522,4780,1102,1430,48,152,2474,4628,1462,2206,3668,324,204,226,827,1131,6194
Ennis Whatley,190,80,University of Alabama,1962,319,5056,599,1284,316,415,3,29,596,1255,139,357,496,1115,269,28,429,498,1517
Eric Anderson,206,99,Indiana University,1970,27,83,12,35,16,27,2,2,10,33,12,19,31,5,3,2,7,23,42
Eric Bledsoe,185,86,University of Kentucky,1989,418,11309,1913,4308,1295,1619,359,1075,1554,3233,337,1246,1583,1924,583,204,1128,827,5480
Eric Dawson,206,113,Midwestern State University,1984,4,39,7,12,1,2,0,0,7,12,5,5,10,0,1,2,3,6,15
Eric Gordon,193,97,Indiana University,1988,492,16471,2772,6437,1584,1940,1023,2690,1749,3747,224,1027,1251,1559,491,159,1050,985,8151
Eric Johnson,188,92,University of Nebraska,1966,48,272,20,84,13,17,1,6,19,78,8,20,28,64,17,2,26,49,54
Eric Leckner,211,120,University of Wyoming,1966,541,6696,858,1730,477,734,0,5,858,1725,449,1300,1749,255,101,164,465,1241,2193
Eric Maynor,190,79,Virginia Commonwealth University,1987,443,6455,732,1872,253,353,179,521,553,1351,106,456,562,1260,182,34,474,483,1896
Eric Mobley,211,106,University of Pittsburgh,1970,152,2246,254,471,116,249,4,6,250,465,193,298,491,79,41,85,153,281,628
Eric Montross,213,122,University of North Carolina,1971,645,11647,1167,2450,334,737,0,3,1167,2447,1018,2031,3049,298,166,401,552,1780,2668
Eric Moreland,208,107,Oregon State University,1991,11,50,4,7,2,4,0,0,4,7,3,9,12,1,0,4,3,5,10
Eric Murdock,185,86,Providence College,1968,581,13555,2133,4897,1158,1472,341,1008,1792,3889,365,1065,1430,2794,965,78,1123,1121,5765
Eric Piatkowski,201,97,University of Nebraska,1970,789,14613,2044,4711,966,1152,865,2168,1179,2543,508,1208,1716,778,404,115,628,1152,5919
Eric Riley,213,111,University of Michigan,1970,186,1844,218,478,138,196,0,4,218,474,180,299,479,60,54,132,126,303,574
Eric Snow,190,86,Michigan State University,1973,910,24050,2223,5238,1497,1968,57,282,2166,4956,438,1784,2222,4422,1035,110,1454,2127,6000
Eric Washington,193,86,University of Alabama,1974,104,2300,274,682,87,115,81,234,193,448,82,134,216,108,78,43,106,230,716
Eric White,203,90,Pepperdine University,1965,93,1224,190,364,113,141,1,1,189,363,99,103,202,43,27,5,73,112,494
Eric Williams,203,99,Providence College,1972,805,19060,2257,5465,2028,2759,290,907,1967,4558,816,1798,2614,1155,659,116,944,1935,6832
Erick Barkley,185,80,St. John's University,1978,27,266,32,90,9,10,4,15,28,75,5,16,21,40,19,1,17,31,77
Erick Dampier,211,120,Mississippi State University,1975,987,24003,2784,5595,1739,2779,2,16,2782,5579,2723,4282,7005,817,330,1398,1435,2869,7309
Erick Green,193,83,Virginia Polytechnic Institute and State Unive...,1991,61,494,71,188,14,16,16,57,55,131,13,30,43,45,14,0,14,34,172
Erick Strickland,190,95,University of Nebraska,1973,551,11019,1414,3667,778,939,434,1246,980,2421,242,1203,1445,1298,466,43,716,1047,4040
Erik Daniels,203,97,University of Kentucky,1982,21,72,6,18,0,0,1,2,5,16,7,11,18,4,2,0,6,7,13
Erik Murphy,208,104,University of Florida,1990,24,62,3,13,0,0,0,3,3,10,2,6,8,2,0,4,2,7,6
Ernest Brown,213,110,Indian Hills Community College,1979,3,21,1,6,1,4,0,0,1,6,1,5,6,0,0,1,3,4,3
Ernie Grunfeld,198,95,University of Tennessee,1955,145,2463,336,739,167,212,28,69,308,670,83,274,357,224,89,20,90,321,867
Ersan Ilyasova,208,106,NaN,1987,765,18886,3176,7237,1264,1650,904,2479,2272,4758,1375,3132,4507,921,543,283,816,1923,8520
Ervin Johnson,188,92,University of Nebraska,1966,845,16989,1393,2756,685,1133,2,10,1391,2746,1677,3471,5148,387,471,1087,724,2430,3473
Esteban Batista,208,122,NaN,1983,70,576,42,96,37,60,0,1,42,95,68,106,174,11,18,11,42,124,121
Etan Thomas,206,116,Syracuse University,1978,409,7084,890,1734,561,930,0,0,890,1734,677,1250,1927,149,128,427,385,889,2341
Etdrick Bohannon,206,99,Auburn University at Montgomery,1973,39,270,16,34,34,52,0,0,16,34,31,44,75,11,4,16,24,57,66
Eugene Jeter,180,79,University of Portland,1983,62,858,106,259,37,41,6,30,100,229,9,61,70,162,29,2,51,54,255
Evan Eschmeyer,211,115,Northwestern University,1975,153,2138,158,341,105,169,0,0,158,341,220,381,601,76,69,95,96,399,421
Evan Fournier,201,92,NaN,1992,319,8392,1393,3130,652,824,480,1266,913,1864,145,679,824,691,255,16,488,754,3918
Evan Turner,201,99,Ohio State University,1988,615,17505,2695,6265,1093,1388,267,884,2428,5381,375,2701,3076,2230,510,136,1217,1282,6750
Everette Stephens,188,79,Purdue University,1966,38,215,25,75,19,24,2,10,23,65,11,12,23,39,9,4,29,22,71
Evers Burns,203,117,University of Maryland,1971,23,143,22,55,12,23,0,0,22,55,13,17,30,9,6,3,7,33,56
Evric Gray,201,106,"University of Nevada, Las Vegas",1969,5,42,4,15,4,4,1,4,3,11,1,2,3,2,1,0,3,5,13
Fab Melo,213,115,Syracuse University,1990,6,36,3,6,1,4,0,0,3,6,0,3,3,0,2,2,1,7,7
Fabricio Oberto,208,111,NaN,1975,336,4871,481,835,119,193,0,4,481,831,443,732,1175,300,89,75,225,733,1081
Fat Lever,190,77,Arizona State University,1960,590,19784,3675,8209,1508,1939,154,493,3521,7716,1261,2819,4080,3898,1378,163,1209,1446,9012
Felipe Lopez,196,90,St. John's University,1974,319,5710,761,1752,409,611,67,199,694,1553,267,571,838,359,223,92,337,607,1998
Felton Spencer,213,120,University of Louisville,1968,713,13856,1333,2750,1060,1630,0,1,1333,2749,1470,2382,3852,235,282,584,755,2391,3726
Fennis Dembo,196,97,University of Wyoming,1966,31,74,14,42,8,10,0,4,14,38,8,15,23,5,1,0,7,15,36
Fernando Martin,206,99,NaN,1962,24,146,9,31,4,11,0,1,9,30,8,20,28,9,7,1,20,24,22
Festus Ezeli,211,115,Vanderbilt University,1989,170,2394,275,536,162,291,0,0,275,536,292,433,725,63,48,166,133,328,712
Forrest McKenzie,201,90,Loyola Marymount University,1963,6,42,7,28,2,2,1,2,6,26,2,5,7,1,1,0,3,9,17
Francisco Elson,213,106,University of California,1976,547,8086,822,1768,301,432,3,17,819,1751,553,1299,1852,286,244,275,403,1103,1948
Francisco Garcia,201,88,University of Louisville,1981,607,12882,1682,3959,632,789,648,1806,1034,2153,286,1205,1491,810,487,426,577,1317,4644
Frank Brickowski,206,108,Pennsylvania State University,1959,846,18859,3304,6416,1746,2352,59,194,3245,6222,1140,2790,3930,1623,744,318,1585,2658,8413
Frank Johnson,185,83,Wake Forest University,1958,367,5860,898,1995,454,586,11,60,887,1935,171,345,516,980,288,17,465,576,2261
Frank Kaminsky,213,109,University of Wisconsin,1993,156,3662,535,1327,226,304,184,556,351,771,126,545,671,260,85,77,134,265,1480
Frank Kornet,206,102,Vanderbilt University,1967,89,595,65,176,31,52,10,38,55,138,35,60,95,30,19,4,34,82,171
Frank Williams,193,86,Portland State University,1956,86,952,92,261,45,54,24,80,68,181,13,64,77,166,34,11,83,87,253
Frankie King,185,83,Western Carolina University,1972,13,79,10,28,6,8,1,3,9,25,5,11,16,7,6,0,5,11,27
Franklin Edwards,185,77,Cleveland State University,1959,113,2225,361,790,185,221,1,15,360,775,33,96,129,418,121,5,218,114,908
Fred Cofield,190,86,Eastern Michigan University,1962,50,496,77,195,12,20,3,16,74,179,7,44,51,86,22,3,50,66,169
Fred Hoiberg,193,92,Iowa State University,1972,541,9978,959,2227,653,765,373,941,586,1286,143,1295,1438,846,428,59,292,783,2944
Fred Jones,193,95,University of Oregon,1979,493,11618,1229,3012,775,955,385,1107,844,1905,180,893,1073,1098,384,131,578,952,3618
Fred Roberts,208,98,Brigham Young University,1960,813,14350,2251,4515,1403,1764,51,154,2200,4361,810,1380,2190,966,388,237,958,1494,5956
Fred VanVleet,183,88,Wichita State University,1994,37,294,39,111,18,22,11,29,28,82,4,38,42,35,17,2,15,36,107
Fred Vinson,193,86,Georgia Institute of Technology,1971,13,67,6,24,2,3,3,13,3,11,0,1,1,1,3,0,6,6,17
Freeman Williams,193,86,Portland State University,1956,9,110,25,67,12,17,7,14,18,53,4,8,12,7,7,1,13,10,69
Furkan Aldemir,208,108,NaN,1991,41,540,40,78,13,27,0,5,40,73,78,98,176,28,17,16,17,96,93
Gabe Pruitt,193,77,University of Southern California,1986,62,461,45,140,18,23,17,60,28,80,10,41,51,52,20,3,24,44,125
Gal Mekel,190,86,Wichita State University,1988,35,335,33,106,8,12,5,23,28,83,5,23,28,76,6,1,33,32,79
Gani Lawal,206,106,Georgia Institute of Technology,1988,1,2,0,0,0,0,0,0,0,0,0,0,0,0,0,0,0,1,0
Garret Siler,211,138,Augusta State University,1986,21,101,17,31,11,22,0,0,17,31,16,12,28,3,1,4,10,20,45
Garrett Temple,198,88,Louisiana State University,1986,425,7336,736,1844,324,461,282,823,454,1021,156,628,784,658,328,107,379,710,2078
Garth Joseph,218,142,College of Saint Rose,1973,8,32,2,10,0,4,0,0,2,10,4,0,4,2,0,2,4,2,4
Gary Alexander,201,108,University of South Florida,1969,22,110,16,28,6,18,0,0,16,28,14,16,30,4,6,0,16,20,38
Gary Forbes,201,99,University of Massachusetts Amherst,1985,111,1504,236,544,125,178,48,141,188,403,55,163,218,103,47,10,100,133,645
Gary Grant,190,83,University of Michigan,1965,552,12602,1864,4140,545,702,95,342,1769,3798,347,936,1283,3013,821,69,1268,1200,4368
Gary Harris,193,95,Michigan State University,1994,188,4940,745,1619,248,314,233,655,512,964,123,339,462,340,207,33,212,306,1971
Gary Leonard,216,113,University of Missouri,1967,31,149,17,37,10,20,0,1,17,36,13,21,34,2,4,10,9,31,44
Gary Neal,193,95,Towson University,1984,458,9814,1656,3995,671,781,578,1547,1078,2448,105,874,979,756,186,11,494,678,4561
Gary Payton,193,81,Oregon State University,1968,6,99,8,22,3,5,1,9,7,13,0,12,12,13,3,4,10,9,20
Gary Payton*,193,81,Oregon State University,1968,1415,50325,9373,20164,3515,4832,1186,3752,8187,16412,1471,4132,5603,9629,2578,305,3217,3398,23447
Gary Plummer,206,97,Boston University,1962,126,1439,198,460,134,187,1,7,197,453,107,200,307,66,29,25,128,268,531
Gary Trent,203,113,Ohio University,1974,560,11226,2033,4085,922,1422,8,62,2025,4023,965,1649,2614,576,258,201,693,1257,4996
Gary Voce,206,108,University of Notre Dame,1965,1,4,1,3,0,0,0,0,1,3,2,0,2,0,0,0,0,0,2
Gaylon Nickerson,190,86,Northwestern Oklahoma State University,1969,8,84,8,24,14,14,0,4,8,20,2,8,10,2,2,2,2,2,30
Geert Hammink,213,118,Louisiana State University,1969,14,44,6,14,10,16,0,0,6,14,5,6,11,2,0,0,4,6,22
Gene Banks,201,97,Duke University,1959,227,6052,894,1643,494,658,1,27,893,1616,426,687,1113,655,198,40,392,605,2283
Geno Carlisle,190,81,University of California,1976,6,16,2,3,4,6,0,0,2,3,1,0,1,1,0,0,1,1,8
Geoff Huston,188,79,Texas Tech University,1957,109,1729,207,419,83,129,3,8,204,411,16,67,83,466,52,4,136,103,500
George Gervin*,201,81,Eastern Michigan University,1952,154,4156,1119,2282,607,706,4,29,1115,2253,157,292,449,322,115,71,359,418,2849
George Hill,190,85,Indiana University-Purdue University Indianapolis,1986,599,17357,2486,5490,1321,1648,746,1965,1740,3525,333,1591,1924,2002,555,176,789,1289,7039
George Johnson,211,111,Stephen F. Austin State University,1947,163,1827,162,368,84,101,2,11,160,357,149,262,411,73,56,131,103,297,410
George Lynch,203,98,University of North Carolina,1970,774,17683,2086,4677,791,1213,146,477,1940,4200,1508,2394,3902,1121,817,258,890,1675,5109
George McCloud,198,92,Florida State University,1967,830,18922,2707,6718,1150,1419,1019,2827,1688,3891,695,1826,2521,1878,654,198,1131,1772,7583
George Zidek,213,113,"University of California, Los Angeles",1973,199,1768,217,542,189,239,2,8,215,534,147,242,389,48,19,17,100,312,625
Georges Niang,203,104,Iowa State University,1993,23,93,9,36,2,2,1,12,8,24,2,15,17,5,3,0,5,6,21
Georgi Glouchkov,203,106,NaN,1960,49,772,84,209,70,122,1,1,83,208,31,132,163,32,26,25,76,124,239
Georgios Papagiannis,216,108,NaN,1997,22,355,56,102,12,14,0,2,56,100,24,62,86,20,3,17,24,44,124
Gerald Brown,198,86,Wayne State University,1935,33,236,33,89,11,14,3,10,30,79,5,17,22,31,5,1,22,21,80
Gerald Fitch,190,85,University of Kentucky,1982,18,239,30,89,17,23,7,26,23,63,7,23,30,33,7,5,15,28,84
Gerald Glass,196,100,University of Mississippi,1967,276,4266,840,1955,181,281,34,149,806,1806,295,367,662,379,166,77,214,475,1895
Gerald Green,201,92,NaN,1986,574,10986,1965,4706,752,923,711,1968,1254,2738,287,1102,1389,560,286,161,667,1060,5393
Gerald Henderson,188,79,Virginia Commonwealth University,1956,1228,28668,4418,9903,2442,3042,532,1552,3886,8351,677,2187,2864,3829,1069,244,1829,2434,11810
Gerald Madkins,193,90,"University of California, Los Angeles",1969,48,420,26,71,16,21,12,32,14,39,3,23,26,65,24,1,29,36,80
Gerald Paddio,201,92,"University of Nevada, Las Vegas",1965,147,1762,327,785,106,146,8,34,319,751,65,135,200,145,42,12,99,113,768
Gerald Wallace,201,97,University of Alabama,1982,961,29500,4189,8975,2953,4116,515,1639,3674,7336,1343,4450,5793,2062,1390,780,1749,2157,11846
Gerald Wilkins,198,83,University of Tennessee at Chattanooga,1963,900,26084,4754,10564,1810,2429,418,1322,4336,9242,975,1671,2646,2697,907,208,1687,1853,11736
Gerard King,183,79,University of Charleston,1928,126,1829,235,467,96,129,0,0,235,467,129,264,393,84,50,27,92,238,566
Gheorghe Muresan,231,137,NaN,1971,307,6729,1265,2206,490,761,0,1,1265,2205,658,1299,1957,150,171,455,446,958,3020
Giannis Antetokounmpo,211,100,NaN,1994,318,10106,1725,3470,1162,1570,125,451,1600,3019,433,1760,2193,1136,358,410,737,931,4737
Gilbert Arenas,190,86,University of Arizona,1982,622,21147,3991,9584,2999,3737,1176,3404,2815,6180,466,1891,2357,3183,958,155,1921,1871,12157
Glen Davis,206,131,Louisiana State University,1986,582,12527,1885,4204,968,1384,14,66,1871,4138,839,1748,2587,534,415,202,604,1397,4752
Glen Rice,201,97,University of Michigan,1967,1016,35137,6790,14919,3234,3826,1565,3920,5225,10999,952,3459,4411,2106,964,266,1744,2379,18379
Glenn Robinson,201,102,Purdue University,1973,872,27802,5846,12752,2585,3179,693,2023,5153,10729,1126,3454,4580,1974,896,420,2224,1961,14970
God Shammgod,183,76,Providence College,1976,20,146,19,58,23,30,0,2,19,56,2,5,7,36,7,1,21,27,61
Goran Dragic,190,86,NaN,1986,795,21741,3879,8199,1826,2432,845,2341,3034,5858,602,1710,2312,3669,806,149,1758,1831,10429
Gordan Giricek,198,95,NaN,1977,589,13844,2223,5054,841,1015,470,1286,1753,3768,270,1231,1501,905,354,74,817,1134,5757
Gordon Hayward,203,102,Butler University,1990,516,16164,2721,6129,1946,2372,689,1873,2032,4256,377,1771,2148,1762,527,215,1059,923,8077
Gorgui Dieng,211,109,University of Louisville,1990,297,7884,1012,1979,591,752,24,70,988,1909,671,1470,2141,486,283,367,427,769,2639
Grant Gondrezick,196,92,Pepperdine University,1963,91,1080,173,395,101,147,7,28,166,367,62,84,146,115,38,5,73,127,454
Grant Hill,203,102,Duke University,1972,1026,34776,6345,13126,4228,5498,219,697,6126,12429,1176,4993,6169,4252,1248,576,2459,2377,17137
Grant Jerrett,208,106,University of Arizona,1993,16,102,14,52,2,2,2,30,12,22,4,14,18,6,4,4,6,22,32
Grant Long,203,102,Eastern Michigan University,1966,1084,31155,3814,8156,2735,3597,94,324,3720,7832,2359,4401,6760,1847,1308,400,1783,3200,10457
Granville Waiters,211,102,Ohio State University,1961,171,1507,147,351,35,67,0,4,147,347,119,194,313,61,32,100,88,246,329
Greg Anderson,208,104,University of Houston,1964,748,14964,2127,4360,989,1783,2,24,2125,4336,1529,3035,4564,401,515,635,1010,1881,5245
Greg Anthony,183,79,"University of Nevada, Las Vegas",1967,817,17364,2097,5225,1119,1536,658,1911,1439,3314,293,1256,1549,3279,964,84,1137,1438,5971
Greg Ballard,201,97,University of Oregon,1955,241,6050,990,2120,293,372,46,122,944,1998,383,912,1295,399,215,56,230,565,2319
Greg Buckner,193,95,Clemson University,1976,570,10895,1120,2491,399,527,239,716,881,1775,457,1136,1593,719,454,111,394,1342,2878
Greg Butler,211,108,Stanford University,1966,55,210,28,79,20,28,0,3,28,76,20,33,53,4,1,2,24,45,76
Greg Dreiling,216,113,University of Kansas,1962,474,4241,375,803,261,402,3,9,372,794,287,731,1018,186,82,137,250,923,1014
Greg Foster,211,108,University of Texas at El Paso,1968,777,9416,1252,2820,517,699,27,116,1225,2704,626,1407,2033,411,112,236,561,1462,3048
Greg Graham,193,78,Indiana University,1970,260,3143,409,1006,279,361,81,251,328,755,76,200,276,253,153,13,225,277,1178
Greg Grant,170,63,Trenton State University,1966,373,4768,448,1144,123,168,56,198,392,946,85,266,351,1065,228,12,307,401,1075
Greg Kelser,201,86,Michigan State University,1957,10,114,21,53,20,28,0,1,21,52,6,13,19,13,7,0,12,16,62
Greg Kite,211,113,Brigham Young University,1961,779,11965,846,1941,341,698,1,7,845,1934,1054,2020,3074,422,216,521,660,1876,2034
Greg Minor,198,95,University of Louisville,1971,277,5144,794,1662,290,378,24,106,770,1556,258,483,741,384,156,46,225,464,1902
Greg Monroe,211,120,Georgetown University,1990,538,15955,3029,5924,1514,2147,0,12,3029,5912,1593,3114,4707,1216,614,332,1060,1250,7572
Greg Oden,213,113,Ohio State University,1988,105,2028,317,552,206,313,0,0,317,552,256,400,656,51,40,130,138,374,840
Greg Ostertag,218,127,University of Kansas,1973,756,14753,1339,2757,833,1465,1,10,1338,2747,1475,2670,4145,443,189,1293,684,1873,3512
Greg Smith,196,88,Western Kentucky University,1947,149,1834,243,394,110,191,0,1,243,393,165,324,489,41,32,59,65,290,596
Greg Stiemsma,211,117,University of Wisconsin,1985,203,3048,269,529,103,146,0,1,269,528,190,489,679,97,118,232,143,512,641
Greg Stokes,208,99,University of Iowa,1963,42,384,57,128,16,23,0,1,57,127,29,33,62,17,14,11,22,64,130
Greg Sutton,188,77,Oral Roberts University,1967,216,2601,357,904,136,182,163,438,194,466,30,173,203,386,109,15,245,409,1013
Greivis Vasquez,198,98,University of Maryland,1987,480,11299,1655,3955,518,626,521,1469,1134,2486,145,1049,1194,2258,267,39,881,910,4349
Guillermo Diaz,188,87,University of Miami,1985,6,18,1,4,3,5,0,1,1,3,2,0,2,1,0,0,0,0,5
Gundars Vetra,198,88,NaN,1967,13,89,19,40,4,6,3,3,16,37,4,4,8,6,2,0,2,12,45
Gus Williams,188,79,University of Southern California,1953,189,5725,1125,2642,416,574,86,310,1039,2332,132,269,401,1200,291,52,427,325,2752
Gustavo Ayon,208,113,NaN,1985,190,2985,376,697,87,183,0,1,376,696,248,540,788,244,122,90,169,379,839
Guy Rucker,211,120,University of Iowa,1977,3,4,0,0,0,0,0,0,0,0,0,1,1,1,0,0,0,1,0
Guy Williams,188,79,University of Southern California,1953,26,144,31,68,5,11,1,4,30,64,15,18,33,9,6,4,8,24,68
Ha Seung-Jin,221,138,NaN,1985,46,316,28,54,14,28,0,0,28,54,20,47,67,3,4,13,26,62,70
Hakeem Olajuwon*,213,115,University of Houston,1963,1238,44222,10749,20991,5423,7621,25,124,10724,20867,4034,9714,13748,3058,2162,3830,3667,4383,26946
Hakim Warrick,206,99,Syracuse University,1982,630,12670,2108,4342,1636,2254,22,120,2086,4222,840,1680,2520,477,255,178,733,1132,5874
Hamady N'Diaye,213,106,Rutgers University,1987,33,157,7,15,6,13,0,0,7,15,7,18,25,3,2,9,6,33,20
Hamed Haddadi,218,115,NaN,1985,181,1378,165,363,93,152,0,5,165,358,180,303,483,55,17,119,123,269,423
Hank McDowell,206,97,University of Memphis,1959,63,406,52,101,30,42,0,2,52,99,28,62,90,17,6,8,21,61,134
Hanno Mottola,211,112,University of Utah,1976,155,2360,292,661,130,166,1,16,291,645,130,312,442,75,31,28,137,337,715
Harold Ellis,196,90,Morehouse College,1970,145,1923,312,592,215,329,1,21,311,571,177,114,291,89,159,18,111,252,840
Harold Jamison,203,117,Clemson University,1976,37,250,29,63,14,33,0,0,29,63,40,20,60,10,7,2,10,40,72
Harold Keeling,193,83,Santa Clara University,1963,20,75,17,39,10,14,0,0,17,39,3,3,6,10,7,0,7,9,44
Harold Miner,196,95,University of Southern California,1971,200,3748,692,1504,394,502,23,74,669,1430,191,241,432,245,80,27,278,370,1801
Harold Pressley,201,95,Villanova University,1963,299,6802,1075,2458,344,442,208,581,867,1877,517,822,1339,628,275,188,410,670,2702
Harrison Barnes,190,92,Northeastern University,1945,386,11425,1757,3876,726,936,365,986,1392,2890,407,1412,1819,564,285,78,415,708,4605
Harvey Catchings,206,98,Hardin-Simmons University,1951,70,1049,72,149,59,89,0,1,72,148,89,173,262,14,15,57,55,162,203
Harvey Grant,203,88,University of Oklahoma,1965,783,20510,3345,7138,1026,1448,65,243,3280,6895,1170,2266,3436,1219,599,428,714,1768,7781
Hasheem Thabeet,221,119,University of Connecticut,1987,291,2869,210,382,151,261,0,0,210,382,243,469,712,31,69,210,148,549,571
Hassan Adams,193,99,University of Arizona,1984,73,547,79,148,27,42,0,1,79,147,36,48,84,14,18,5,26,51,185
Hassan Whiteside,213,120,Marshall University,1989,217,5891,1210,2069,522,855,0,0,1210,2069,692,1782,2474,93,130,568,354,570,2942
Haywoode Workman,188,81,Oral Roberts University,1966,395,7552,779,1876,362,476,133,411,646,1465,151,694,845,1471,374,21,556,721,2053
Hedo Turkoglu,208,99,NaN,1979,1078,29235,4173,9756,2180,2801,1373,3556,2800,6200,692,3635,4327,3175,822,333,1710,2650,11899
Henry Ellenson,211,111,Marquette University,1997,19,146,23,64,4,8,10,35,13,29,8,33,41,7,1,1,14,6,60
Henry James,203,99,St. Mary's University,1965,222,2791,493,1190,218,268,155,415,338,775,113,216,329,88,51,18,141,315,1359
Henry Sims,208,112,Georgetown University,1990,181,3417,533,1130,311,409,4,24,529,1106,352,555,907,192,104,84,194,405,1381
Henry Turner,188,88,University of Nebraska,1938,66,464,81,179,60,100,2,8,79,171,39,39,78,29,25,8,38,60,224
Henry Walker,196,83,NaN,1984,216,3784,506,1097,156,203,240,631,266,466,70,419,489,193,116,30,170,458,1408
Herb Williams,208,109,Ohio State University,1958,993,24456,4023,8795,1520,2186,7,75,4016,8720,1294,4156,5450,1391,498,1315,1527,2568,9573
Hersey Hawkins,190,86,Bradley University,1966,983,32034,4889,10612,3466,3985,1226,3108,3663,7504,825,2729,3554,2860,1622,302,1828,2043,14470
Hilton Armstrong,211,106,University of Connecticut,1984,378,4201,412,848,215,381,4,12,408,836,361,617,978,137,123,175,280,687,1043
Hiram Fuller,206,108,"California State University, Fresno",1981,4,43,3,8,2,6,0,0,3,8,4,7,11,2,0,1,4,5,8
Hollis Thompson,203,93,Georgetown University,1991,305,7176,819,1995,222,316,395,1036,424,959,218,721,939,327,186,74,224,610,2255
Horace Grant,208,97,Clemson University,1965,1165,38621,5439,10695,2114,3053,4,63,5435,10632,3467,5976,9443,2575,1143,1136,1303,2832,12996
Horace Jenkins,185,81,William Paterson University,1974,15,104,15,45,12,13,0,9,15,36,3,6,9,9,5,1,7,6,42
Horacio Llamas,211,129,Grand Canyon University,1973,28,143,23,49,11,18,1,3,22,46,8,28,36,5,11,8,20,39,58
Hot Rod,193,83,NaN,1935,887,26327,3688,7681,2406,3315,2,19,3686,7662,2070,3928,5998,1592,746,1456,1208,2253,9784
Howard Carter,196,97,Louisiana State University,1961,11,66,4,23,1,1,0,3,4,20,1,2,3,4,1,0,8,4,9
Howard Eisley,188,80,Boston College,1972,934,18416,2121,5293,965,1166,590,1716,1531,3577,243,1291,1534,3185,625,96,1341,1953,5797
Howard Nathan,180,79,University of Louisiana at Monroe,1972,5,15,5,9,3,4,0,1,5,8,0,0,0,2,3,0,8,2,13
Howard Wright,190,83,Austin Peay State University,1947,34,338,42,99,32,50,0,2,42,97,25,67,92,6,8,10,22,56,116
Hubert Davis,196,83,University of North Carolina,1970,768,16913,2305,5044,695,827,806,1823,1499,3221,239,953,1192,1286,334,45,730,1144,6111
Ian Clark,190,79,Belmont University,1991,226,2271,364,812,95,117,122,338,242,474,46,195,241,193,82,29,130,199,945
Ian Lockhart,203,108,University of Tennessee,1967,1,2,1,1,2,2,0,0,1,1,0,0,0,0,0,0,0,0,4
Ian Mahinmi,211,113,NaN,1986,469,7902,912,1692,597,1003,0,6,912,1686,676,1371,2047,230,263,341,435,1207,2421
Ibo Kutluay,198,90,NaN,1974,5,12,0,1,0,0,0,0,0,1,0,1,1,0,0,0,2,1,0
Igor Rakocevic,190,83,NaN,1978,42,244,22,58,29,36,5,12,17,46,4,13,17,33,4,0,23,25,78
Ike Diogu,203,113,Arizona State University,1983,313,3770,654,1298,523,665,2,4,652,1294,376,572,948,97,47,94,279,570,1833
Iman Shumpert,196,99,Georgia Institute of Technology,1990,432,11006,1207,3029,373,496,446,1311,761,1718,335,1165,1500,839,514,106,544,1026,3233
Ime Udoka,198,97,Portland State University,1977,316,5711,614,1471,189,268,218,612,396,859,219,707,926,308,208,54,221,528,1635
Ira Bowman,196,88,University of Pennsylvania,1973,17,68,7,11,1,2,0,1,7,10,1,4,5,9,3,0,2,3,15
Ira Newble,201,99,Miami University,1975,429,8343,858,1927,301,387,101,298,757,1629,450,789,1239,360,232,113,323,764,2118
Irving Thomas,203,102,Florida State University,1966,26,108,17,50,12,21,0,0,17,50,14,17,31,10,4,1,13,24,46
Isaac Austin,208,115,Arizona State University,1969,510,10616,1701,3772,929,1387,9,59,1692,3713,816,1771,2587,713,275,282,907,1198,4340
Isaac Fontaine,193,95,Washington State University,1975,6,75,3,14,4,6,1,5,2,9,0,5,5,4,0,0,4,6,11
Isaiah Canaan,183,91,Murray State University,1991,232,4686,646,1738,299,362,401,1126,245,612,69,352,421,392,144,23,256,359,1992
Isaiah Morris,203,103,University of Arkansas,1969,25,102,26,57,3,4,0,0,26,57,6,6,12,4,3,1,8,14,55
Isaiah Rider,196,97,"University of Nevada, Las Vegas",1971,563,17851,3583,8085,1572,1935,667,1896,2916,6189,676,1490,2166,1535,367,136,1425,1327,9405
Isaiah Taylor,190,77,University of Texas at Austin,1994,4,52,1,7,1,2,0,2,1,5,1,2,3,3,1,1,0,6,3
Isaiah Thomas,185,81,Indiana University,1961,508,14940,3061,6948,2421,2768,995,2707,2066,4241,279,1014,1293,2562,488,51,1174,1107,9538
Isaiah Whitehead,193,96,Seton Hall University,1995,73,1643,204,508,91,113,44,149,160,359,32,152,184,192,42,36,142,175,543
Ish Smith,183,79,Wake Forest University,1988,657,11487,1788,4408,450,683,205,680,1583,3728,220,1240,1460,2375,466,132,851,715,4231
Isiah Thomas*,185,81,Indiana University,1961,744,26983,5347,11851,2978,3840,323,1124,5024,10727,686,1928,2614,6948,1308,170,2750,2076,13995
Ivan Johnson,203,104,University of Oregon,1984,125,1969,326,631,153,231,3,19,323,612,141,351,492,78,99,32,140,247,808
Ivan McFarlin,203,108,Oklahoma State University,1982,11,41,5,13,5,7,0,1,5,12,7,4,11,1,0,0,1,8,15
Ivano Newbill,206,111,Georgia Institute of Technology,1970,134,1430,76,193,45,104,1,1,75,192,140,214,354,50,50,29,71,213,198
Ivica Zubac,216,120,NaN,1997,38,609,126,238,32,49,0,3,126,235,41,118,159,30,14,33,30,66,284
J.J. Anderson,190,83,NaN,1960,44,457,61,149,27,45,0,2,61,147,29,53,82,21,29,9,32,70,149
J.J. Barea,203,94,NaN,1984,695,13482,2283,5403,777,972,634,1804,1649,3599,215,1184,1399,2513,269,18,1011,1008,5977
J.J. Hickson,218,122,NaN,1986,623,13605,2312,4603,1115,1830,0,24,2312,4579,1345,2761,4106,517,319,358,869,1165,5739
J.J. O'Brien,185,81,NaN,1992,2,6,0,1,0,0,0,0,0,1,0,1,1,0,1,0,0,1,0
J.J. Redick,188,86,NaN,1984,768,19544,3143,7052,1592,1790,1436,3515,1707,3537,146,1349,1495,1572,361,61,863,1136,9314
J.R. Bremer,206,117,NaN,1981,136,2389,257,780,111,151,139,434,118,346,36,181,217,266,74,11,107,144,764
J.R. Giddens,216,115,NaN,1985,70,486,58,123,26,46,0,20,58,103,34,71,105,26,19,4,35,59,142
J.R. Henderson,206,104,NaN,1980,30,331,35,96,25,45,2,5,33,91,20,27,47,22,9,4,18,29,97
J.R. Reid,203,106,NaN,1966,861,19599,2743,5790,1765,2428,5,44,2738,5746,1242,3062,4304,809,641,322,1202,2565,7256
J.R. Smith,188,86,NaN,1920,950,25810,4421,10524,1463,1994,1937,5173,2484,5351,495,2538,3033,2107,976,212,1316,2169,12242
JaJuan Johnson,206,113,Wake Forest University,1987,36,298,54,121,6,9,0,0,54,121,20,38,58,6,5,14,14,25,114
JaKarr Sampson,211,106,University of California,1983,220,3451,426,980,223,338,59,253,367,727,127,416,543,169,84,92,216,419,1134
JaMychal Green,206,102,University of Alabama,1990,203,3875,534,1089,253,324,70,202,464,887,344,663,1007,159,102,77,205,487,1391
JaVale McGee,213,122,"University of Nevada, Reno",1988,577,10507,1982,3578,698,1242,1,10,1981,3568,1114,1908,3022,189,219,930,583,1259,4663
Jabari Brown,193,97,University of Missouri,1992,19,568,70,170,64,85,23,62,47,108,3,33,36,40,12,2,32,33,227
Jabari Parker,203,113,Duke University,1995,152,4874,971,1976,383,512,78,229,893,1747,252,595,847,314,151,56,255,307,2403
Jabari Smith,211,113,Louisiana State University,1977,131,1244,151,366,99,145,1,11,150,355,57,149,206,77,43,32,59,197,402
Jack Cooley,206,117,University of Notre Dame,1991,16,87,9,22,9,21,0,0,9,22,10,15,25,1,6,3,3,23,27
Jack Haley,208,108,"University of California, Los Angeles",1964,408,4372,572,1369,397,601,0,4,572,1365,455,767,1222,108,78,60,288,744,1541
Jack Sikma,211,104,Illinois Wesleyan University,1955,540,17428,2872,6296,1938,2216,201,589,2671,5707,1071,3487,4558,1729,582,507,1105,1938,7883
Jackie Butler,208,113,NaN,1985,69,848,137,254,69,89,0,0,137,254,73,132,205,30,20,31,73,143,343
Jackson Vroman,208,99,Iowa State University,1981,133,1816,190,464,117,194,0,6,190,458,161,275,436,91,62,49,149,288,497
Jacque Vaughn,185,86,University of Kansas,1975,776,12658,1300,3028,768,986,95,270,1205,2758,148,880,1028,1919,403,15,792,1267,3463
Jae Crowder,198,106,Marquette University,1990,465,10544,1422,3286,683,872,514,1516,908,1770,343,1412,1755,632,464,146,350,861,4041
Jahidi White,206,131,Georgetown University,1976,396,6778,835,1633,545,1029,0,1,835,1632,804,1401,2205,70,144,406,463,1063,2215
Jahlil Okafor,211,124,Duke University,1995,103,2725,639,1252,239,352,1,6,638,1246,203,410,613,123,42,110,215,262,1518
Jake Layman,206,95,University of Maryland,1994,35,249,26,89,13,17,13,51,13,38,6,18,24,11,9,3,11,22,78
Jake Tsakalidis,218,129,NaN,1979,351,5395,609,1256,363,552,0,1,609,1255,478,864,1342,106,81,235,292,740,1581
Jake Voskuhl,211,111,University of Connecticut,1977,450,6443,673,1381,467,654,1,3,672,1378,562,977,1539,237,148,166,340,1166,1814
Jakob Poeltl,213,112,University of Utah,1995,54,626,67,115,31,57,0,0,67,115,78,87,165,12,17,20,29,113,165
Jalen Rose,203,95,University of Michigan,1973,1144,35558,6188,14040,3486,4341,963,2722,5225,11318,596,3447,4043,4392,888,395,2626,2999,16825
Jamaal Franklin,196,86,San Diego State University,1991,24,174,17,41,2,2,6,13,11,28,5,20,25,9,4,3,14,27,42
Jamaal Magloire,211,117,University of Kentucky,1978,711,14907,1781,3730,1411,2220,0,7,1781,3723,1437,3060,4497,393,225,613,1028,1842,4973
Jamaal Tinsley,190,88,Iowa State University,1978,547,14443,1759,4481,737,1029,397,1326,1362,3155,345,1260,1605,3330,776,155,1375,1306,4652
Jamaal Wilkes*,198,86,"University of California, Los Angeles",1953,55,956,174,368,73,93,1,4,173,364,48,75,123,56,26,5,65,84,422
Jamal Crawford,196,90,University of Michigan,1980,1247,38603,6687,16304,3799,4407,2191,6255,4496,10049,460,2497,2957,4411,1161,263,2430,1939,19364
Jamal Mashburn,203,108,University of Kentucky,1972,680,24926,4563,10965,2483,3260,857,2503,3706,8462,766,2799,3565,2618,710,121,1699,1719,12466
Jamal Murray,193,93,University of Kentucky,1997,82,1764,295,730,106,120,115,344,180,386,41,173,214,170,52,24,113,124,811
Jamal Robinson,198,95,"University of Nevada, Las Vegas",1955,6,72,3,22,0,0,0,2,3,20,3,8,11,2,6,0,3,7,6
Jamal Sampson,211,106,University of California,1983,72,631,53,108,36,67,0,1,53,107,80,162,242,26,9,32,33,91,142
Jamario Moon,203,92,Meridian Community College,1980,425,9561,1046,2290,267,326,280,844,766,1446,282,1475,1757,438,343,329,212,622,2639
Jameer Nelson,183,86,Saint Joseph's University,1982,891,24933,3900,8952,1215,1507,1201,3268,2699,5684,446,2191,2637,4582,791,70,1874,2250,10216
Jamel Thomas,198,97,Providence College,1973,19,148,22,55,2,2,1,9,21,46,6,13,19,12,5,0,16,10,47
James Anderson,198,96,Oklahoma State University,1989,286,4721,577,1402,200,261,217,671,360,731,126,506,632,333,136,60,241,317,1571
James Augustine,208,106,University of Illinois at Urbana-Champaign,1984,27,156,19,37,4,8,0,0,19,37,17,16,33,4,5,2,6,20,42
James Bailey,206,99,Rutgers University,1957,221,3953,579,1272,330,444,0,9,579,1263,345,680,1025,151,92,141,323,792,1488
James Blackwell,183,86,Dartmouth College,1968,26,160,16,26,4,6,0,0,16,26,4,18,22,22,8,0,10,16,36
James Collins,193,88,Florida State University,1973,23,103,21,55,8,14,9,20,12,35,7,7,14,3,6,3,8,12,59
James Cotton,201,90,University of Wyoming,1924,19,92,14,39,21,27,0,7,14,32,4,12,16,0,4,1,9,9,49
James Donaldson,218,124,Washington State University,1957,784,22975,2440,4389,1607,2107,0,0,2440,4389,1789,4838,6627,614,278,1002,1139,1667,6487
James Edwards,213,102,University of Washington,1955,729,15318,2942,6060,1938,2738,1,13,2941,6047,824,2051,2875,714,177,319,1084,2234,7823
James Ennis,201,95,"California State University, Long Beach",1990,170,3210,355,794,215,272,134,348,221,446,162,357,519,154,103,46,136,310,1059
James Harden,196,99,Arizona State University,1989,615,20688,4005,9053,4226,4951,1382,3801,2623,5252,475,2618,3093,3526,904,274,2068,1564,13618
James Johnson,206,113,Wake Forest University,1987,512,10177,1524,3206,600,869,192,655,1332,2551,446,1327,1773,955,400,497,729,1130,3840
James Jones,190,81,Assumption College,1949,709,11098,1205,3003,531,632,776,1937,429,1066,226,1051,1277,366,227,218,231,930,3717
James Lang,208,129,NaN,1983,11,55,4,9,3,5,0,0,4,9,5,6,11,2,0,3,2,14,11
James Michael,198,90,NaN,1992,108,856,131,245,61,116,3,10,128,235,79,106,185,36,33,46,41,107,326
James Nunnally,201,92,"University of California, Santa Barbara",1990,26,330,30,92,12,18,16,50,14,42,2,36,38,16,12,4,14,22,88
James Posey,203,97,Xavier University,1977,947,25778,2804,6843,1599,1947,1105,3196,1699,3647,845,3642,4487,1597,1023,313,1125,2527,8312
James Robinson,198,95,"University of Nevada, Las Vegas",1955,412,7441,1117,2847,410,615,421,1225,696,1622,217,505,722,771,227,79,548,708,3065
James Scott,198,81,St. John's University,1972,8,32,0,8,1,2,0,4,0,4,1,5,6,3,2,0,2,5,1
James Singleton,203,97,Murray State University,1981,300,4229,459,1037,248,296,42,157,417,880,429,757,1186,140,125,160,189,503,1208
James Southerland,203,97,Syracuse University,1990,8,60,10,30,2,4,6,12,4,18,0,16,16,0,2,4,2,6,28
James Thomas,198,97,Providence College,1973,66,534,44,78,20,40,0,0,44,78,58,94,152,10,8,14,28,96,108
James White,206,131,Georgetown University,1976,67,583,71,162,23,34,17,50,54,112,8,60,68,35,17,6,25,53,182
James Worthy*,206,102,University of North Carolina,1961,767,25616,5936,11542,2114,2706,116,476,5820,11066,1247,2547,3794,2452,873,490,1500,1510,14102
James Young,198,97,University of Kentucky,1995,89,751,72,196,23,42,35,127,37,69,19,75,94,26,24,5,14,54,202
JamesOn Curry,190,86,Oklahoma State University,1986,1,0,0,0,0,0,0,0,0,0,0,0,0,0,0,0,0,0,0
Jamie Feick,206,115,Michigan State University,1974,270,5792,474,1118,274,440,17,44,457,1074,709,1230,1939,189,158,122,217,590,1239
Jamie Waller,193,97,Virginia Union University,1964,9,91,16,40,10,18,0,2,16,38,9,4,13,3,4,1,11,13,42
Jamie Watson,201,86,University of South Carolina,1972,125,1588,157,341,71,101,16,50,141,291,57,139,196,150,87,21,117,185,401
Jamison Brewer,193,83,Auburn University,1980,54,468,35,94,11,28,8,32,27,62,15,35,50,56,19,2,32,34,89
Jan Vesely,211,108,NaN,1990,216,3231,352,678,83,213,0,2,352,676,306,447,753,117,160,119,159,505,787
Jannero Pargo,185,79,University of Arkansas,1979,562,8435,1387,3551,354,409,461,1302,926,2249,130,643,773,1123,281,37,648,740,3589
Jared Cunningham,193,88,Oregon State University,1991,141,1095,102,299,107,157,32,108,70,191,10,90,100,67,38,4,55,129,343
Jared Dudley,201,102,Boston College,1985,808,18921,2369,5052,944,1298,810,2042,1559,3010,835,1897,2732,1256,691,144,724,1477,6492
Jared Jeffries,211,104,Indiana University,1981,741,15974,1331,3128,691,1185,96,372,1235,2756,1358,1609,2967,935,528,411,771,1807,3449
Jared Reiner,211,115,University of Iowa,1982,46,376,25,73,4,14,0,0,25,73,34,75,109,14,8,13,23,80,54
Jared Sullinger,206,117,Ohio State University,1992,269,6532,1172,2686,408,564,141,518,1031,2168,684,1322,2006,477,180,161,332,784,2893
Jarell Eddie,201,98,Virginia Polytechnic Institute and State Unive...,1991,31,209,26,84,16,17,19,63,7,21,3,27,30,5,6,1,2,6,87
Jarell Martin,208,108,Louisiana State University,1994,69,938,112,267,85,112,9,27,103,240,81,167,248,23,25,16,47,149,318
Jaren Jackson,193,86,Georgetown University,1967,431,7210,865,2215,294,385,346,980,519,1235,207,579,786,500,258,53,348,725,2370
Jarnell Stokes,206,119,University of Tennessee,1994,35,169,28,48,18,34,0,0,28,48,19,25,44,8,8,5,7,30,74
Jarrett Jack,190,90,Georgia Institute of Technology,1983,888,24314,3445,7867,2100,2455,628,1831,2817,6036,275,2194,2469,3846,702,109,1718,1587,9618
Jarrod Uthoff,206,100,University of Iowa,1993,9,115,16,38,5,7,3,9,13,29,8,14,22,9,2,4,3,8,40
Jarron Collins,193,88,Florida State University,1973,570,8723,688,1521,738,1056,0,5,688,1516,659,944,1603,421,142,99,341,1345,2114
Jarvis Hayes,201,99,University of Georgia,1981,427,9898,1397,3363,367,460,392,1101,1005,2262,244,1086,1330,459,312,56,374,852,3553
Jarvis Varnado,206,104,Mississippi State University,1988,74,794,78,134,58,112,0,0,78,134,42,102,144,32,22,62,32,144,214
Jason Caffey,203,115,University of Alabama,1973,542,10468,1502,3118,947,1482,0,10,1502,3108,1001,1365,2366,487,234,130,752,1329,3951
Jason Collier,193,88,Florida State University,1973,151,2178,338,743,158,214,7,20,331,723,175,268,443,51,36,32,120,295,841
Jason Collins,193,88,Florida State University,1973,847,16530,980,2376,835,1308,7,35,973,2341,1001,1943,2944,659,403,394,671,2335,2802
Jason Hart,190,83,Syracuse University,1978,421,6505,745,1793,391,490,71,238,674,1555,103,610,713,931,311,40,338,654,1952
Jason Kapono,203,96,"University of California, Los Angeles",1981,509,9068,1336,3026,269,322,457,1054,879,1972,165,679,844,417,180,25,327,777,3398
Jason Kidd,193,92,University of California,1973,1526,54981,6737,16879,3350,4284,2168,6178,4569,10701,1926,7648,9574,13393,2944,496,4411,2851,18992
Jason Lawson,211,108,Villanova University,1974,17,80,9,15,8,10,0,0,9,15,8,19,27,5,4,4,2,14,26
Jason Maxiell,201,117,University of Cincinnati,1983,618,11379,1398,2823,685,1214,0,5,1398,2818,1048,1528,2576,266,230,490,487,1197,3481
Jason Miskiri,188,79,George Mason University,1975,1,3,0,1,0,0,0,1,0,0,0,0,0,1,0,0,0,2,0
Jason Richardson,198,99,Michigan State University,1981,1009,34366,6495,14711,2189,3072,1926,5148,4569,9563,1177,3718,4895,2577,1164,408,1693,2271,17105
Jason Sasser,201,102,Texas Tech University,1974,22,177,23,57,1,2,2,6,21,51,4,19,23,6,8,0,6,26,49
Jason Smith,211,113,Louisiana State University,1977,563,9554,1506,3186,516,664,71,194,1435,2992,622,1348,1970,425,202,389,478,1263,3599
Jason Terry,188,83,University of Arizona,1977,1359,41220,6855,15431,2763,3269,2242,5895,4613,9536,497,2729,3226,5356,1560,262,2390,2525,18715
Jason Thompson,185,83,University of South Carolina,1946,635,15290,2164,4363,1018,1546,11,57,2153,4306,1296,2718,4014,664,295,434,762,1831,5357
Jason Williams,206,108,St. John's University,1968,815,23483,3087,7766,898,1104,1248,3822,1839,3944,195,1645,1840,4663,944,61,1661,1108,8320
Javaris Crittenton,196,90,Georgia Institute of Technology,1987,226,3706,458,1036,250,392,24,104,434,932,168,384,552,402,118,16,274,296,1190
Jawad Williams,206,108,St. John's University,1968,90,1153,127,344,41,57,45,144,82,200,24,109,133,56,22,8,35,109,340
Jawann Oldham,213,97,Seattle University,1957,229,4100,455,957,183,299,0,3,455,954,332,728,1060,122,77,448,262,629,1093
Jay Edwards,213,102,University of Washington,1955,4,26,3,7,1,3,0,2,3,5,1,1,2,4,1,0,1,4,7
Jay Guidinger,208,115,University of Minnesota Duluth,1969,64,346,35,87,28,46,0,0,35,87,41,56,97,20,13,15,26,71,98
Jay Humphries,190,83,University of Colorado,1962,874,25072,3794,7934,1663,2138,224,760,3570,7174,582,1608,2190,4753,1243,94,1677,2385,9475
Jay Murphy,206,99,Boston College,1962,67,436,63,190,34,56,0,3,63,187,34,77,111,13,8,7,24,59,160
Jay Taylor,190,86,Eastern Illinois University,1967,17,114,21,52,6,9,3,13,18,39,5,6,11,5,5,3,10,9,51
Jay Vincent,201,99,Michigan State University,1959,423,9888,2087,4508,1096,1368,5,24,2082,4484,557,1378,1935,667,248,104,679,974,5275
Jay Williams,206,108,St. John's University,1968,75,1961,273,685,103,161,65,202,208,483,27,168,195,350,86,17,171,179,714
Jaylen Brown,193,97,University of Missouri,1992,78,1341,192,423,85,124,46,135,146,288,45,175,220,64,35,18,68,142,515
Jayson Williams,206,108,St. John's University,1968,475,9805,1360,3092,749,1236,3,24,1357,3068,1587,1997,3584,287,204,301,515,1284,3472
Jeff Adrien,201,111,University of Connecticut,1986,206,3109,407,832,257,407,0,2,407,830,323,642,965,138,74,115,130,367,1071
Jeff Ayres,188,83,NaN,1945,237,2322,287,519,114,147,2,5,285,514,196,436,632,99,37,66,132,360,690
Jeff Cook,208,97,Idaho State University,1956,249,3681,352,763,171,240,0,5,352,758,347,559,906,180,95,76,138,600,875
Jeff Cross,208,108,University of Maine,1961,21,128,6,24,14,25,0,0,6,24,9,21,30,1,2,3,6,38,26
Jeff Foote,213,120,Cornell University,1987,4,39,2,6,0,0,0,0,2,6,1,5,6,0,0,1,2,5,4
Jeff Foster,211,107,Texas State University,1977,764,15750,1472,2961,796,1295,7,54,1465,2907,2101,3147,5248,703,507,308,613,1921,3747
Jeff Grayer,196,90,Iowa State University,1965,443,8311,1340,2936,550,829,37,143,1303,2793,574,724,1298,637,273,65,488,739,3267
Jeff Green,196,88,University of Maryland,1941,938,29028,4635,10644,2428,3059,935,2838,3700,7806,903,3437,4340,1515,709,504,1438,2121,12633
Jeff Hornacek,190,86,Iowa State University,1963,1157,36784,6401,12961,3233,3686,898,2263,5503,10698,979,2946,3925,5700,1663,239,2142,2550,16933
Jeff Lamp,198,88,University of Virginia,1959,188,2825,517,1097,228,273,16,64,501,1033,112,322,434,249,86,10,152,338,1278
Jeff Lebo,188,81,University of North Carolina,1966,4,32,2,7,2,2,0,0,2,7,2,2,4,3,2,0,1,7,6
Jeff Malone,193,92,Mississippi State University,1961,933,30754,7292,15030,3039,3490,74,275,7218,14755,574,1874,2448,2154,610,92,1535,1681,17697
Jeff Martin,196,88,Murray State University,1967,143,2685,384,921,159,229,29,103,355,818,131,159,290,109,78,47,96,201,956
Jeff McInnis,193,86,University of North Carolina,1974,646,18292,2523,5828,827,1039,351,1056,2172,4772,276,1070,1346,2944,443,37,909,1357,6224
Jeff Nordgaard,201,102,University of Wisconsin-Green Bay,1973,13,48,5,18,8,9,0,0,5,18,4,10,14,3,2,0,3,7,18
Jeff Ruland,208,108,Iona College,1958,96,2930,506,899,367,524,0,6,506,893,271,552,823,338,63,60,336,302,1379
Jeff Sanders,203,102,Georgia Southern University,1966,55,462,49,124,14,23,0,0,49,124,41,62,103,25,18,9,32,64,112
Jeff Taylor,193,79,Texas Tech University,1960,12,44,6,10,9,10,0,0,6,10,1,3,4,3,2,1,8,4,21
Jeff Teague,188,84,Wake Forest University,1988,600,16175,2682,6001,1671,1979,510,1436,2172,4565,192,1253,1445,3310,713,205,1349,1119,7545
Jeff Trepagnier,193,90,University of Southern California,1979,31,270,34,101,14,20,6,13,28,88,17,26,43,22,19,4,25,20,88
Jeff Turner,206,104,Vanderbilt University,1962,612,11244,1543,3304,538,700,73,212,1470,3092,621,1415,2036,635,215,85,687,1758,3697
Jeff Webster,203,105,University of Oklahoma,1971,11,58,8,23,0,0,2,6,6,17,2,5,7,3,4,0,3,7,18
Jeff Wilkins,211,104,Illinois State University,1955,229,3757,579,1330,177,266,0,1,579,1329,226,684,910,173,57,60,195,487,1335
Jeff Withey,213,104,University of Kansas,1990,197,2033,243,458,165,230,0,4,243,454,180,328,508,64,56,153,74,226,651
Jeffery Taylor,193,79,Texas Tech University,1960,132,2566,299,731,127,191,82,257,217,474,80,183,263,107,72,21,92,234,807
Jeffrey Sheppard,190,86,University of Kentucky,1974,18,185,15,39,8,13,2,7,13,32,6,16,22,16,3,0,7,12,40
Jelani McCoy,208,111,"University of California, Los Angeles",1977,260,3824,510,947,180,367,0,0,510,947,285,636,921,135,75,193,245,521,1200
Jerald Honeycutt,206,111,Tulane University,1974,70,734,108,285,50,78,39,111,69,174,33,84,117,39,30,10,67,115,305
Jerami Grant,203,95,Syracuse University,1994,302,6505,679,1607,506,809,170,534,509,1073,224,747,971,306,160,353,283,657,2034
Jerel McNeal,190,90,Marquette University,1987,6,36,3,11,2,2,1,2,2,9,0,3,3,2,3,1,5,5,9
Jeremy Evans,206,90,Western Kentucky University,1987,249,2621,363,639,145,211,6,26,357,613,238,402,640,107,90,121,84,290,877
Jeremy Lamb,196,83,University of Connecticut,1992,276,4688,847,1928,288,350,232,715,615,1213,114,716,830,316,148,87,184,411,2214
Jeremy Lin,190,90,Harvard University,1988,405,10757,1642,3796,1165,1449,393,1124,1249,2672,175,984,1159,1807,471,162,958,913,4842
Jeremy Pargo,188,99,Gonzaga University,1986,122,1734,248,650,100,151,60,186,188,464,28,107,135,239,41,4,146,138,656
Jeremy Richardson,198,83,Delta State University,1984,78,397,52,149,7,10,24,61,28,88,5,31,36,7,8,0,17,36,135
Jeremy Tyler,208,117,NaN,1991,125,1102,166,373,63,112,0,1,166,372,104,185,289,26,24,44,74,174,395
Jerian Grant,203,95,Syracuse University,1994,139,2293,282,692,161,196,71,234,211,458,40,214,254,297,97,18,131,190,796
Jermaine Jackson,193,92,University of Detroit Mercy,1976,188,1903,129,332,121,169,4,29,125,303,53,149,202,258,61,15,112,178,383
Jermaine O'Neal,211,102,NaN,1978,1079,29391,5509,11795,3182,4430,14,96,5495,11699,2117,5577,7694,1491,499,1956,2016,3107,14214
Jermaine Taylor,193,79,Texas Tech University,1960,99,1269,233,511,75,102,33,112,200,399,73,97,170,80,38,13,111,93,574
Jermareo Davidson,208,104,University of Alabama,1984,52,433,68,160,26,45,0,0,68,160,31,65,96,14,9,18,22,58,162
Jerome Allen,193,83,University of Pennsylvania,1973,193,2248,192,547,110,180,70,219,122,328,55,166,221,353,83,13,172,210,564
Jerome Beasley,208,107,University of North Dakota,1980,2,5,1,3,0,0,0,0,1,3,0,1,1,0,0,0,0,0,2
Jerome Dyson,190,81,University of Connecticut,1987,9,180,19,48,28,36,1,8,18,40,2,17,19,18,11,2,20,19,67
Jerome Harmon,193,86,University of Louisville,1969,10,158,21,53,3,6,1,1,20,52,9,14,23,12,9,0,7,12,46
Jerome Henderson,211,104,University of New Mexico,1959,7,39,6,16,4,4,0,0,6,16,2,6,8,0,1,1,6,13,16
Jerome James,213,136,Florida Agricultural and Mechanical University,1975,358,4771,650,1339,240,389,0,2,650,1337,393,706,1099,118,92,384,403,989,1540
Jerome Jordan,213,114,University of Tulsa,1986,65,491,67,127,46,54,0,0,67,127,66,66,132,17,9,21,24,73,180
Jerome Kersey,201,97,Longwood University,1962,1153,28115,4723,10166,2321,3364,58,288,4665,9878,2330,4009,6339,2134,1439,799,1583,3455,11825
Jerome Lane,198,104,University of Pittsburgh,1966,232,3392,511,1172,168,447,1,16,510,1156,599,725,1324,339,140,40,275,574,1191
Jerome Moiso,208,106,"University of California, Los Angeles",1978,165,1512,167,341,80,131,0,4,167,337,136,296,432,39,48,74,111,196,414
Jerome Whitehead,208,99,Marquette University,1956,419,7017,1012,2170,444,621,0,1,1012,2169,630,1171,1801,173,157,103,352,1112,2468
Jerome Williams,206,93,Georgetown University,1973,714,15574,1719,3469,1220,1863,1,37,1718,3432,1758,2842,4600,591,765,156,724,1487,4659
Jerrelle Benimon,203,111,Towson University,1991,2,3,0,0,0,0,0,0,0,0,1,2,3,0,0,0,1,0,0
Jerrod Mustaf,208,107,University of Maryland,1969,179,1902,285,635,151,233,0,2,285,633,145,307,452,99,54,46,144,237,721
Jerry Eaves,193,81,University of Louisville,1959,6,63,4,14,7,8,0,0,4,14,1,0,1,4,1,0,6,12,15
Jerry Reynolds,203,90,Louisiana State University,1962,443,8379,1420,3399,1168,1560,28,124,1392,3275,467,850,1317,904,486,250,718,677,4036
Jerry Sichting,185,76,Purdue University,1956,429,7740,1094,2132,287,334,51,159,1043,1973,106,342,448,1072,226,9,349,575,2526
Jerry Smith,188,86,University of Louisville,1987,5,46,3,14,0,0,1,6,2,8,2,5,7,4,5,0,0,5,7
Jerry Stackhouse,198,98,University of North Carolina,1974,1049,32767,5810,14157,5003,6109,1035,3397,4775,10760,1031,2302,3333,3481,958,496,2865,1985,17658
Jerryd Bayless,190,90,University of Arizona,1988,656,14086,1994,4822,1181,1440,541,1496,1453,3326,198,1205,1403,1961,427,79,956,1369,5710
Jeryl Sasser,198,90,Southern Methodist University,1979,82,1061,67,221,57,83,13,44,54,177,67,124,191,67,48,12,41,94,204
Jim Farmer,193,86,University of Alabama,1964,163,1910,376,866,191,261,27,101,349,765,106,148,254,149,55,6,156,222,970
Jim Grandholm,213,106,University of South Florida,1960,26,168,30,58,10,21,9,17,21,41,20,30,50,8,2,8,11,33,79
Jim Jackson,198,99,Ohio State University,1970,1201,39133,6265,14757,2870,3483,1194,3300,5071,11457,1549,3983,5532,3929,991,249,2930,2695,16594
Jim Lampley,208,104,University of Arkansas at Little Rock,1960,1,16,1,3,1,2,0,0,1,3,1,4,5,0,1,0,1,0,3
Jim Les,180,74,Bradley University,1963,328,4314,377,952,283,347,196,496,181,456,89,314,403,951,172,20,305,430,1233
Jim McIlvaine,216,108,Marquette University,1972,401,5927,423,948,225,408,1,10,422,938,479,764,1243,105,136,691,231,1052,1072
Jim Paxson,198,90,University of Dayton,1932,434,10005,1884,3976,880,1059,71,285,1813,3691,224,526,750,1175,402,45,517,762,4719
Jim Petersen,208,106,University of Minnesota,1962,491,9802,1371,2821,653,901,2,28,1369,2793,766,1588,2354,487,213,363,662,1354,3397
Jim Rowinski,203,113,Purdue University,1961,32,142,16,40,32,38,0,0,16,40,19,20,39,5,1,2,10,19,64
Jim Thomas,190,86,Indiana University,1960,89,2142,354,745,184,236,8,42,346,703,77,192,269,247,82,6,141,207,900
Jimmer Fredette,188,88,Brigham Young University,1989,290,3685,625,1485,214,244,234,592,391,893,60,228,288,388,106,14,268,254,1698
Jimmy Butler,201,99,Marquette University,1989,399,12880,2007,4483,1856,2241,338,1002,1669,3481,568,1353,1921,1254,583,183,562,567,6208
Jimmy Carruth,208,120,Virginia Polytechnic Institute and State Unive...,1969,4,21,2,3,1,1,0,0,2,3,0,4,4,0,0,2,1,4,5
Jimmy King,188,79,University of Tulsa,1941,64,890,112,261,56,81,5,34,107,227,45,67,112,90,24,13,61,78,285
Jimmy Oliver,196,92,Purdue University,1969,78,856,135,332,44,57,17,50,118,282,18,62,80,55,27,3,33,66,331
Jiri Welsch,201,94,NaN,1980,318,5913,665,1651,498,660,152,454,513,1197,146,623,769,478,231,20,335,515,1980
Jo Jo,190,81,NaN,1947,50,577,74,178,20,36,11,32,63,146,12,42,54,46,18,13,46,85,179
Joakim Noah,211,104,University of Florida,1985,618,17863,2129,4342,1299,1858,0,15,2129,4327,2071,3718,5789,1807,511,840,1073,1764,5557
Joao Vianna,206,97,NaN,1966,1,9,1,2,0,0,0,0,1,2,0,0,0,2,0,0,1,3,2
Jodie Meeks,193,95,University of Kentucky,1987,514,11606,1591,3805,812,925,737,1982,854,1823,141,940,1081,544,401,36,396,624,4731
Joe Alexander,203,104,West Virginia University,1986,67,745,103,251,60,86,16,47,87,204,46,74,120,44,16,30,52,116,282
Joe Arlauckas,206,104,Niagara University,1965,9,85,14,43,6,8,0,0,14,43,6,7,13,8,3,4,4,16,34
Joe Barry,193,88,Georgia Institute of Technology,1969,541,15067,3144,7077,1522,1969,0,10,3144,7067,1015,2605,3620,926,459,797,1268,1517,7810
Joe Binion,203,106,North Carolina Agricultural and Technical Stat...,1961,11,51,4,10,6,10,0,0,4,10,8,10,18,1,2,2,3,5,14
Joe Cooper,208,104,University of Colorado,1957,3,45,7,15,3,6,0,0,7,15,3,6,9,2,2,1,0,7,17
Joe Courtney,203,106,University of Southern Mississippi,1969,169,1298,197,455,92,140,4,6,193,449,106,125,231,45,35,40,77,185,490
Joe Crawford,196,95,University of Kentucky,1986,2,23,3,10,2,2,1,4,2,6,1,3,4,1,1,0,0,2,9
Joe Crispin,183,83,Pennsylvania State University,1979,42,312,52,136,24,26,30,78,22,58,4,18,22,52,10,0,20,20,158
Joe Dumars*,190,86,McNeese State University,1963,1018,35139,5994,13026,3423,4059,990,2592,5004,10434,671,1532,2203,4612,902,83,2084,1826,16401
Joe Harris,198,99,University of Virginia,1991,108,1646,203,486,44,64,117,309,86,177,23,168,191,82,37,10,83,184,567
Joe Ingles,203,102,NaN,1987,242,4886,475,1096,93,126,276,691,199,405,64,522,586,502,223,22,270,385,1319
Joe Johnson,201,90,University of Iowa,1947,1379,47648,8304,18802,2902,3618,2096,5629,6208,13173,1177,4258,5435,5415,1173,277,2632,2445,21606
Joe Kleine,211,115,University of Arkansas,1962,1099,16971,2146,4803,1011,1259,15,53,2131,4750,1454,3118,4572,724,311,326,922,2290,5318
Joe Kopicki,206,108,University of Detroit Mercy,1960,42,308,50,95,43,54,2,3,48,92,29,57,86,29,13,1,28,58,145
Joe Meriweather,208,97,Southern Illinois University,1953,76,1061,121,243,96,124,1,2,120,241,94,169,263,27,17,28,50,181,339
Joe Smith,213,106,University of Southern Colorado,1944,1324,33766,5474,12061,3095,3929,33,149,5441,11912,3030,5101,8131,1264,756,1037,1625,3706,14076
Joe Stephens,201,95,University of Arkansas at Little Rock,1973,22,227,30,84,7,10,4,21,26,63,18,27,45,12,12,3,11,14,71
Joe Wolf,211,104,University of North Carolina,1964,679,10866,1223,2830,365,475,18,117,1205,2713,658,1510,2168,664,279,137,558,1466,2829
Joe Young,188,81,University of Oregon,1992,74,519,88,241,31,40,15,69,73,172,7,60,67,80,19,0,38,35,222
Joel Anthony,206,111,"University of Nevada, Las Vegas",1982,523,7242,410,808,272,413,0,0,410,808,577,814,1391,101,130,543,230,836,1092
Joel Bolomboy,206,106,Weber State University,1994,12,53,9,16,3,6,1,4,8,12,4,13,17,2,1,2,2,1,22
Joel Embiid,213,113,University of Kansas,1994,31,786,200,429,191,244,36,98,164,331,61,182,243,66,27,76,117,112,627
Joel Freeland,208,113,NaN,1987,151,1821,209,455,59,81,0,2,209,453,190,328,518,65,32,56,74,255,477
Joel Przybilla,216,115,University of Minnesota,1979,645,12599,939,1718,528,958,0,3,939,1715,1181,2740,3921,276,167,868,621,1736,2406
Joey Dorsey,203,121,University of Memphis,1983,145,1594,151,286,65,172,0,1,151,285,214,342,556,57,70,46,92,277,367
Joey Graham,201,102,Oklahoma State University,1982,377,6117,857,1776,471,578,54,180,803,1596,272,786,1058,207,134,43,309,804,2239
Joffrey Lauvergne,211,99,NaN,1991,223,3269,527,1141,172,243,82,265,445,876,248,621,869,209,71,37,188,324,1308
Johan Petro,213,112,NaN,1986,522,7821,1049,2290,264,395,2,15,1047,2275,578,1416,1994,243,212,249,402,1265,2364
John Amaechi,208,122,Pennsylvania State University,1970,294,4811,663,1646,510,760,1,13,662,1633,230,542,772,228,90,94,386,499,1837
John Bagley,183,83,Boston College,1960,521,14418,1941,4418,749,963,112,442,1829,3976,347,1130,1477,3480,623,45,1224,903,4743
John Battle,188,79,Rutgers University,1962,612,10910,2054,4430,1168,1472,62,227,1992,4203,178,646,824,1257,273,43,659,874,5338
John Celestand,193,80,Villanova University,1977,16,185,15,45,5,6,2,9,13,36,1,10,11,20,7,0,16,22,37
John Coker,213,114,Boise State University,1971,25,141,18,44,5,6,0,0,18,44,12,17,29,3,2,3,4,22,41
John Crotty,185,83,University of Virginia,1969,504,6177,676,1573,552,658,158,411,518,1162,144,389,533,1062,192,20,461,628,2062
John Drew,198,92,Gardner-Webb University,1954,19,463,107,260,94,122,0,4,107,256,36,46,82,35,22,2,42,65,308
John Edwards,213,124,Kent State University,1981,65,435,42,94,15,25,0,0,42,94,26,41,67,8,6,19,20,88,99
John Henson,211,103,University of North Carolina,1990,315,5994,1025,1921,368,643,0,6,1025,1915,590,1032,1622,314,135,480,365,702,2418
John Jenkins,193,97,Vanderbilt University,1991,188,2330,340,760,121,143,111,312,229,448,38,232,270,151,39,13,113,107,912
John Long,196,88,University of Detroit Mercy,1956,530,10777,2151,4786,815,916,101,284,2050,4502,352,691,1043,927,413,61,664,841,5218
John Lucas,190,79,University of Maryland,1953,601,11109,1819,4294,773,994,370,1118,1449,3176,210,708,918,2431,491,21,744,693,4781
John Morton,190,81,Seton Hall University,1967,153,2149,240,621,220,277,15,74,225,547,60,127,187,374,105,24,214,188,715
John Paxson,188,83,University of Notre Dame,1960,723,16799,2342,4675,465,572,269,747,2073,3928,163,710,873,2609,507,42,619,1383,5418
John Salley,211,104,Georgia Institute of Technology,1964,790,17197,1934,3837,1542,2161,3,14,1931,3823,1272,2224,3496,970,470,1010,1004,2509,5413
John Salmons,201,95,University of Miami,1979,1133,31181,4110,9476,2133,2646,1033,2760,3077,6716,549,2820,3369,2802,985,308,1527,2139,11386
John Schweitz,198,95,University of Richmond,1960,22,117,25,75,7,10,0,4,25,71,6,16,22,18,0,1,16,14,57
John Shasky,211,106,University of Minnesota,1964,136,1505,176,378,165,252,0,2,176,376,158,221,379,34,29,35,75,179,517
John Starks,190,81,Oklahoma State University,1965,903,24704,4156,10132,1751,2270,1281,3762,2875,6370,427,1803,2230,3266,993,110,1600,2395,11344
John Stockton*,185,77,Gonzaga University,1962,1504,47764,7039,13658,4788,5796,845,2203,6194,11455,966,3085,4051,15806,3265,315,4244,3942,19711
John Stroeder,208,117,University of Montana,1958,51,315,33,89,20,30,0,2,33,87,34,65,99,26,3,16,30,54,86
John Thomas,198,92,Marquette University,1948,278,2915,284,572,158,251,0,2,284,570,257,301,558,79,94,64,161,498,726
John Turner,203,111,Phillips University,1967,42,345,43,98,31,59,0,0,43,98,38,40,78,12,6,4,32,40,117
John Wall,193,88,University of Kentucky,1990,500,18031,3417,7888,2159,2728,426,1327,2991,6561,292,1925,2217,4610,870,322,1913,1138,9419
John Wallace,203,102,Syracuse University,1974,381,6143,1152,2496,582,786,15,50,1137,2446,328,733,1061,281,134,216,470,706,2901
John Williams,188,83,New Mexico State University,1951,435,10952,1769,3921,803,1140,65,289,1704,3632,632,1569,2201,1262,566,184,684,1020,4406
Johnny Davis,188,77,University of Dayton,1955,208,3948,633,1479,491,576,18,72,615,1407,51,178,229,860,117,12,308,288,1775
Johnny Dawkins,188,74,Duke University,1963,541,14859,2361,5175,1082,1262,180,545,2181,4630,333,1003,1336,2997,618,29,1108,837,5984
Johnny Moore,185,79,University of Texas at Austin,1958,228,5417,819,1807,320,431,59,226,760,1581,171,457,628,1424,420,30,472,479,2017
Johnny Newman,201,86,University of Richmond,1963,1240,30132,4769,10335,3410,4209,624,1876,4145,8459,1036,1680,2716,1760,1133,273,1746,3395,13572
Johnny O'Bryant,206,116,Louisiana State University,1993,122,1385,160,389,49,79,7,13,153,376,109,169,278,61,23,14,68,164,376
Johnny Rogers,208,102,"University of California, Irvine",1963,69,636,116,246,19,28,0,7,116,239,38,66,104,29,13,11,30,89,251
Johnny Taylor,206,99,University of Tennessee at Chattanooga,1974,60,900,105,263,28,39,29,72,76,191,38,88,126,27,33,21,46,129,267
Jon Barry,193,88,Georgia Institute of Technology,1969,890,15385,1756,4040,930,1094,728,1841,1028,2199,344,1328,1672,1951,782,120,875,1111,5170
Jon Brockman,201,115,University of Washington,1987,150,1570,118,242,84,136,0,1,118,241,212,260,472,49,33,9,57,267,320
Jon Koncak,213,113,Southern Methodist University,1963,784,16409,1444,3073,613,1027,19,84,1425,2989,1064,2792,3856,785,542,791,624,2474,3520
Jon Leuer,208,103,University of Wisconsin,1989,356,5594,923,1926,282,374,124,370,799,1556,336,998,1334,290,130,95,237,528,2252
Jon Sundvold,188,77,University of Missouri,1961,429,7527,1430,3154,302,359,217,539,1213,2615,109,354,463,1230,191,4,479,520,3379
Jonas Jerebko,208,104,NaN,1987,563,10201,1312,2886,535,694,320,896,992,1990,732,1539,2271,458,317,141,412,1096,3479
Jonas Valanciunas,213,120,NaN,1992,363,9483,1630,2932,899,1151,1,4,1629,2928,972,2113,3085,240,136,387,530,1033,4160
Jonathan Bender,211,91,NaN,1981,262,3847,509,1221,334,438,101,297,408,924,153,429,582,170,43,169,258,391,1453
Jonathan Gibson,188,83,New Mexico State University,1987,17,231,35,95,21,29,15,45,20,50,1,21,22,26,8,0,21,21,106
Jonathan Kerner,211,111,East Carolina University,1974,1,5,0,1,0,0,0,0,0,1,0,0,0,0,0,0,0,2,0
Jonathon Simmons,185,83,New York University,1924,133,2205,299,663,168,224,48,149,251,514,36,220,256,184,71,30,129,249,814
Jonny Flynn,183,83,Syracuse University,1989,192,4154,597,1510,313,390,128,383,469,1127,52,294,346,730,128,9,418,202,1635
Jordan Adams,196,94,"University of California, Los Angeles",1994,32,263,37,92,17,28,10,26,27,66,9,21,30,19,19,7,16,26,101
Jordan Clarkson,196,87,University of Missouri,1992,220,6425,1219,2765,429,530,266,797,953,1968,198,552,750,611,227,27,395,427,3133
Jordan Crawford,196,95,University of Kentucky,1986,469,11385,2094,5116,877,1053,528,1686,1566,3430,254,942,1196,1493,320,37,882,719,5593
Jordan Farmar,188,81,"University of California, Los Angeles",1986,504,9840,1460,3452,385,521,583,1559,877,1893,161,797,958,1453,391,56,695,713,3888
Jordan Hamilton,178,72,University of North Texas,1948,211,3119,489,1215,109,154,207,582,282,633,121,502,623,179,117,54,148,211,1294
Jordan Hill,208,106,University of Arizona,1987,495,8867,1538,3099,591,852,3,27,1535,3072,1016,1734,2750,358,178,320,487,1038,3670
Jordan McRae,198,83,University of Tennessee,1991,81,774,126,306,69,90,38,95,88,211,14,66,80,69,14,8,44,65,359
Jordan Mickey,203,106,Louisiana State University,1994,41,198,23,56,13,24,0,1,23,55,19,28,47,8,3,17,10,17,59
Jordan Williams,188,83,New Mexico State University,1951,43,635,77,152,43,66,0,0,77,152,66,90,156,11,21,15,23,61,197
Jorge Garbajosa,206,111,NaN,1977,74,1983,230,554,57,78,72,209,158,345,50,295,345,128,81,15,65,92,589
Jorge Gutierrez,190,86,University of California,1988,67,657,75,147,37,49,3,20,72,127,13,66,79,91,25,1,44,90,190
Jose Calderon,190,90,NaN,1981,903,24796,3267,6904,975,1111,1011,2452,2256,4452,313,1941,2254,5522,742,75,1430,1466,8520
Jose Ortiz,208,102,Oregon State University,1963,64,391,74,167,34,57,1,3,73,164,38,35,73,18,10,8,41,55,183
Joseph Forte,193,87,University of North Carolina,1981,25,125,11,47,8,10,0,6,11,41,5,12,17,17,6,0,13,7,30
Josh Akognon,180,83,"California State University, Fullerton",1986,3,9,2,4,0,0,1,2,1,2,0,1,1,1,0,0,0,3,5
Josh Boone,208,107,University of Connecticut,1984,256,4482,567,1042,206,463,0,0,567,1042,484,774,1258,125,99,178,169,466,1340
Josh Childress,203,95,Stanford University,1983,391,10432,1343,2571,763,980,99,301,1244,2270,732,1118,1850,609,339,184,439,725,3548
Josh Davis,188,77,University of Dayton,1955,73,515,58,157,23,32,23,72,35,85,52,67,119,20,19,5,22,73,162
Josh Grant,206,101,University of Utah,1967,53,382,59,146,22,29,17,61,42,85,27,62,89,24,18,8,30,62,157
Josh Harrellson,208,124,University of Kentucky,1989,75,888,105,240,22,35,33,95,72,145,80,147,227,26,30,36,33,96,265
Josh Howard,201,95,Wake Forest University,1980,542,16268,2916,6549,1519,1969,365,1115,2551,5434,876,2135,3011,865,556,287,769,1388,7716
Josh Huestis,201,104,Stanford University,1991,7,86,11,23,0,5,6,10,5,13,6,13,19,3,1,5,3,3,28
Josh McRoberts,208,108,Duke University,1987,498,9752,1070,2314,374,523,220,659,850,1655,561,1450,2011,1042,254,221,447,946,2734
Josh Powell,206,102,North Carolina State University,1983,353,4319,541,1229,253,342,7,20,534,1209,355,665,1020,182,54,80,283,552,1342
Josh Richardson,198,90,University of Tennessee,1993,105,2721,325,785,102,140,128,342,197,443,56,219,275,213,96,64,100,239,880
Josh Selby,188,83,University of Kansas,1991,38,296,31,94,18,25,3,21,28,73,2,18,20,34,9,0,36,24,83
Josh Smith,213,106,University of Southern Colorado,1944,1029,32168,5629,12579,2532,4070,563,1949,5066,10630,1917,5454,7371,3156,1204,1876,2480,2804,14353
Jrue Holiday,193,92,"University of California, Los Angeles",1990,504,16257,2847,6458,930,1180,567,1551,2280,4907,403,1397,1800,3147,732,197,1358,1146,7191
Juan Carlos,203,92,NaN,1980,82,2117,308,766,124,146,156,432,152,334,34,176,210,177,48,1,134,94,896
Juan Dixon,190,74,University of Maryland,1978,570,11103,1805,4354,669,799,440,1270,1365,3084,197,852,1049,995,438,45,707,972,4719
Juan Hernangomez,206,104,NaN,1995,62,842,101,224,57,76,46,113,55,111,43,144,187,29,29,12,31,62,305
Juaquin Hawkins,201,99,"California State University, Long Beach",1973,58,685,57,148,10,20,10,24,47,124,16,62,78,47,29,6,29,57,134
Jud Buechler,198,99,University of Arizona,1968,814,9418,1034,2410,214,341,284,779,750,1631,478,956,1434,615,354,159,325,816,2566
Julian Wright,203,102,University of Kansas,1987,231,3049,397,795,97,166,16,61,381,734,184,347,531,182,132,69,164,182,907
Julius Erving*,201,95,University of Massachusetts Amherst,1950,212,6927,1531,3171,818,1045,26,99,1505,3072,456,592,1048,672,324,285,580,532,3906
Julius Hodge,201,95,North Carolina State University,1983,32,163,17,37,9,16,0,0,17,37,9,14,23,30,10,0,14,19,43
Julius Nwosu,208,115,Liberty University,1971,23,84,9,28,13,17,0,0,9,28,11,13,24,3,0,3,9,20,31
Julius Randle,206,113,University of Kentucky,1994,156,4432,736,1611,397,554,27,99,709,1512,323,1142,1465,408,102,66,323,491,1896
Julyan Stone,198,90,University of Texas at El Paso,1988,47,327,22,50,13,18,4,19,18,31,9,39,48,51,12,6,18,35,61
Jumaine Jones,203,98,University of Georgia,1979,471,9780,1294,3052,312,443,425,1218,869,1834,552,1435,1987,408,307,144,388,870,3325
Junior Bridgeman,196,95,University of Louisville,1953,172,3621,738,1612,303,345,21,63,717,1549,98,307,405,314,88,28,199,259,1800
Junior Burrough,203,109,University of Virginia,1973,61,495,64,170,61,93,0,0,64,170,45,64,109,15,15,10,40,74,189
Junior Harrington,193,81,Wingate University,1980,140,3096,290,782,133,193,20,73,270,709,69,312,381,428,126,25,250,401,733
Justin Anderson,198,103,University of Virginia,1993,205,3103,443,1053,248,313,138,471,305,582,156,466,622,161,101,71,156,263,1272
Justin Dentmon,180,83,University of Washington,1985,14,186,20,58,8,12,4,28,16,30,0,16,16,20,4,0,14,20,52
Justin Hamilton,213,117,Louisiana State University,1990,162,2745,362,775,127,156,81,261,281,514,193,351,544,127,93,103,103,247,932
Justin Harper,208,102,University of Richmond,1989,22,150,18,53,1,3,8,29,10,24,5,13,18,4,3,3,12,10,45
Justin Holiday,198,83,University of Washington,1989,256,3984,516,1277,163,207,208,608,308,669,63,429,492,277,172,87,182,292,1403
Justin Reed,203,108,University of Mississippi,1982,208,2433,293,726,211,285,0,5,293,721,129,181,310,109,54,34,131,382,797
Justin Williams,208,102,University of Wyoming,1984,72,579,80,146,39,115,0,1,80,145,91,122,213,2,15,26,23,85,199
Justise Winslow,201,102,Duke University,1996,96,2857,275,687,109,164,39,151,236,536,104,393,497,183,95,32,128,236,698
Jusuf Nurkic,213,127,NaN,1994,224,4432,814,1693,385,651,0,7,814,1686,498,993,1491,336,176,260,427,620,2013
Juwan Howard,206,108,University of Michigan,1973,1412,42735,7663,16320,3647,4774,6,55,7657,16265,2772,5916,8688,3082,946,402,2889,4121,18979
K.J. McDaniels,198,90,NaN,1992,259,3949,527,1278,288,372,133,457,394,821,176,430,606,180,133,182,285,380,1475
Kalin Lucas,185,88,Michigan State University,1989,1,6,0,1,0,0,0,0,0,1,0,0,0,0,1,0,0,1,0
Kaniel Dickens,203,97,University of Idaho,1978,19,85,8,20,3,4,3,9,5,11,5,7,12,2,2,2,3,9,22
Kannard Johnson,206,99,Western Kentucky University,1965,4,12,1,3,0,0,0,0,1,3,0,0,0,0,1,0,2,1,2
Kareem Abdul-Jabbar*,218,102,"University of California, Los Angeles",1947,390,11703,2831,5100,1197,1611,1,10,2830,5090,668,1767,2435,941,265,566,840,1143,6860
Kareem Rush,198,97,University of Missouri,1980,394,6924,1033,2595,210,294,339,942,694,1653,124,537,661,421,170,81,345,533,2615
Karl Malone*,206,113,Louisiana Tech University,1963,1476,54852,13528,26210,9787,13188,85,310,13443,25900,3562,11406,14968,5248,2085,1145,4524,4578,36928
Karl-Anthony Towns,213,110,University of Kentucky,1995,164,5657,1427,2632,579,703,131,363,1296,2269,525,1340,1865,381,115,241,395,486,3564
Kasib Powell,201,97,Texas Tech University,1981,11,304,35,95,6,9,8,33,27,62,8,36,44,18,9,2,5,18,84
Kawhi Leonard,201,104,San Diego State University,1991,398,12154,2377,4798,1236,1459,518,1334,1859,3464,503,1966,2469,903,704,280,542,697,6508
Kay Felder,175,79,Oakland University,1995,42,386,62,158,35,49,7,22,55,136,3,38,41,58,18,7,31,38,166
Kebu Stewart,203,108,"California State University, Bakersfield",1973,15,110,12,26,16,25,0,0,12,26,9,22,31,2,5,2,8,13,40
Kedrick Brown,201,100,Okaloosa-Walton Community College,1981,198,2904,320,755,74,116,84,267,236,488,139,354,493,167,115,35,93,250,798
Keith Appling,185,83,Michigan State University,1992,5,27,2,8,2,2,0,3,2,5,0,1,1,1,1,0,3,5,6
Keith Askins,201,89,University of Alabama,1967,486,7983,677,1688,223,311,275,774,402,914,525,903,1428,375,278,170,321,1094,1852
Keith Benson,208,106,Indiana University,1954,3,9,0,1,0,0,0,0,0,1,2,1,3,0,0,0,0,0,0
Keith Bogans,196,97,University of Kentucky,1980,808,17711,1816,4627,758,1052,853,2438,963,2189,477,1797,2274,1058,543,81,705,1495,5243
Keith Booth,198,102,University of Maryland,1974,45,449,51,157,27,48,1,11,50,146,27,70,97,39,22,11,42,63,130
Keith Closs,221,96,Central Connecticut State University,1976,130,1647,201,427,100,165,0,4,201,423,133,239,372,44,28,163,78,167,502
Keith Jennings,170,72,East Tennessee State University,1968,164,2955,353,809,248,291,136,364,217,445,44,204,248,614,164,2,201,213,1090
Keith Langford,193,97,University of Kansas,1983,2,10,1,4,0,0,0,0,1,4,0,2,2,0,0,0,0,1,2
Keith Lee,208,97,University of Memphis,1962,182,2907,456,1012,200,268,2,12,454,1000,282,579,861,178,74,110,216,489,1114
Keith McLeod,188,85,Bowling Green State University,1979,248,4441,436,1206,389,478,75,254,361,952,44,267,311,626,169,32,296,410,1336
Keith Owens,201,102,"University of California, Los Angeles",1969,20,80,9,32,8,10,0,0,9,32,8,7,15,3,5,4,2,11,26
Keith Smart,185,79,Indiana University,1964,2,12,0,2,2,2,0,1,0,1,0,1,1,2,0,0,2,0,2
Keith Smith,190,77,University of North Carolina,1965,42,461,57,150,21,28,3,9,54,141,13,19,32,43,25,3,30,74,138
Keith Tower,211,113,University of Notre Dame,1970,53,416,39,91,20,36,0,1,39,90,25,44,69,7,6,12,19,69,98
Keith Van,208,104,NaN,1977,709,21992,4063,9126,2194,2624,744,2030,3319,7096,1360,3344,4704,1095,576,349,1512,2121,11064
Kelenna Azubuike,196,99,University of Kentucky,1983,208,5025,802,1748,364,473,210,514,592,1234,257,572,829,230,130,103,203,408,2178
Kelly McCarty,201,90,University of Southern Mississippi,1975,2,4,2,3,0,0,0,0,2,3,2,1,3,0,0,0,2,0,4
Kelly Olynyk,213,107,Gonzaga University,1991,278,5756,998,2094,378,509,254,691,744,1403,376,933,1309,471,194,128,374,810,2628
Kelly Oubre,201,92,University of Kansas,1995,142,2276,276,653,106,148,79,267,197,386,86,307,393,60,80,24,83,295,737
Kelly Tripucka,198,99,University of Notre Dame,1959,491,13137,2638,5647,1793,2052,147,389,2491,5258,473,1217,1690,1355,457,84,1040,1046,7216
Kelvin Cato,211,115,Iowa State University,1974,568,10950,1159,2300,739,1142,1,13,1158,2287,904,2040,2944,248,298,697,466,1399,3058
Kelvin Ransey,185,77,Ohio State University,1958,160,3193,531,1159,243,290,5,35,526,1124,74,172,246,607,138,11,227,262,1310
Kelvin Upshaw,188,81,University of Utah,1963,192,2522,430,947,147,190,21,89,409,858,58,177,235,428,134,13,203,343,1028
Kemba Walker,203,95,University of Kentucky,1964,443,15008,2845,6915,1655,2001,792,2257,2053,4658,265,1443,1708,2381,606,175,927,682,8137
Ken Bannister,206,106,Saint Augustine's College,1960,253,3867,586,1202,329,669,0,4,586,1198,276,617,893,111,109,80,347,669,1501
Ken Green,203,97,University of Texas-Pan American,1959,7,72,13,27,5,9,0,0,13,27,12,15,27,2,4,0,1,8,31
Ken Johnson,203,108,Michigan State University,1962,80,971,128,251,39,91,0,0,128,251,94,181,275,19,14,34,65,167,295
Ken Norman,203,97,University of Illinois at Urbana-Champaign,1964,646,18992,3737,7695,1012,1786,231,741,3506,6954,1352,2597,3949,1355,517,431,1173,1483,8717
Kendall Gill,196,88,University of Illinois at Urbana-Champaign,1968,1013,31164,5314,12196,2601,3443,341,1130,4973,11066,1346,2888,4234,3205,1583,456,1865,2646,13570
Kendall Marshall,193,90,University of North Carolina,1991,160,3083,315,789,44,72,128,346,187,443,23,230,253,779,107,10,285,180,802
Kendrick Perkins,208,122,NaN,1984,878,19037,1873,3574,885,1506,0,15,1873,3559,1458,3625,5083,888,287,971,1383,2394,4631
Kennard Winchester,196,95,Averett University,1966,141,1109,185,444,68,87,14,43,171,401,63,83,146,54,30,27,49,120,452
Kenneth Faried,203,103,Morehead State University,1989,409,10539,1958,3596,940,1440,2,19,1956,3577,1299,2181,3480,432,322,356,569,1047,4858
Kenny Anderson,183,76,Georgia Institute of Technology,1970,1092,31948,4867,11603,2723,3459,703,2016,4164,9587,827,2410,3237,6417,1547,131,2182,2480,13160
Kenny Battle,198,95,University of Illinois at Urbana-Champaign,1964,206,2832,387,781,217,294,7,55,380,726,225,294,519,172,160,51,148,332,998
Kenny Carr,201,99,North Carolina State University,1955,152,4120,623,1228,393,550,0,9,623,1219,367,947,1314,209,92,60,309,503,1639
Kenny Fields,196,99,"University of California, Los Angeles",1962,232,3575,622,1329,284,382,6,28,616,1301,239,373,612,249,129,49,234,517,1534
Kenny Gattison,203,102,Old Dominion University,1964,494,9927,1536,2956,850,1309,1,12,1535,2944,744,1583,2327,444,290,327,602,1419,3923
Kenny Green,203,97,University of Texas-Pan American,1959,101,1078,191,454,84,117,0,2,191,452,60,114,174,25,14,20,85,114,466
Kenny Natt,190,83,University of Louisiana at Monroe,1958,16,58,4,12,4,8,0,0,4,12,4,2,6,6,4,0,6,6,12
Kenny Payne,203,88,University of Louisville,1966,144,1167,218,532,55,64,17,58,201,474,45,125,170,61,38,22,67,129,508
Kenny Satterfield,188,84,University of Cincinnati,1981,114,1564,183,565,70,96,17,83,166,482,49,89,138,244,71,5,139,115,453
Kenny Smith,190,77,University of North Carolina,1965,864,25399,4006,8402,1879,2267,749,1883,3257,6519,303,1352,1655,4634,857,73,1889,1358,10640
Kenny Thomas,201,118,University of New Mexico,1977,771,21451,2936,6306,1519,2139,60,247,2876,6059,1816,3589,5405,1239,656,321,1301,1977,7451
Kenny Walker,203,95,University of Kentucky,1964,448,9050,1240,2556,641,856,7,34,1233,2522,742,1051,1793,299,235,299,351,1184,3128
Kenny Williams,188,79,St. John's University,1961,260,2918,547,1070,153,225,0,14,547,1056,315,378,693,161,76,166,136,366,1247
Kent Bazemore,196,91,Old Dominion University,1989,418,7459,1093,2579,461,681,345,993,748,1586,119,969,1088,630,344,153,512,699,2992
Kent Benson,208,106,Indiana University,1954,219,3652,544,1130,190,237,3,12,541,1118,301,631,932,212,151,124,173,543,1281
Kentavious Caldwell-Pope,196,92,University of Georgia,1993,314,9488,1345,3320,496,632,479,1435,866,1885,209,732,941,495,367,59,313,591,3665
Kenton Edelin,203,92,University of Virginia,1962,10,143,4,13,3,8,0,0,4,13,8,18,26,10,5,4,3,39,11
Kenyon Martin,206,106,University of Cincinnati,1977,757,23134,3875,8031,1509,2398,66,282,3809,7749,1312,3847,5159,1439,893,864,1318,2498,9325
Keon Clark,211,99,"University of Nevada, Las Vegas",1975,434,9691,1428,2878,665,1051,1,20,1427,2858,791,1739,2530,394,216,725,560,1257,3522
Kermit Washington,203,104,American University,1951,6,56,7,14,2,2,0,0,7,14,9,10,19,0,4,4,4,13,16
Kerry Kittles,196,81,Villanova University,1974,507,16929,2779,6337,913,1171,694,1838,2085,4499,513,1470,1983,1295,811,221,621,893,7165
Kevin Brooks,198,90,University of Louisiana at Lafayette,1969,126,1031,172,429,61,71,12,60,160,369,40,101,141,48,18,6,69,84,417
Kevin Burleson,190,92,University of Minnesota,1979,39,340,22,88,16,17,10,54,12,34,4,22,26,48,26,2,25,63,70
Kevin Duckworth,213,124,Eastern Illinois University,1964,749,18337,3346,7143,1740,2373,5,25,3341,7118,1445,2723,4168,627,350,337,1315,2387,8437
Kevin Durant,206,108,University of Texas at Austin,1988,703,26278,6463,13254,4935,5596,1260,3321,5203,9933,553,4478,5031,2663,840,738,2221,1330,19121
Kevin Edwards,190,86,DePaul University,1965,643,15819,2707,6424,1150,1430,182,540,2525,5884,536,1171,1707,1648,851,198,1168,1056,6746
Kevin Gamble,196,95,University of Iowa,1965,714,15833,2714,5485,840,1038,272,748,2442,4737,391,1179,1570,1400,505,184,630,1375,6540
Kevin Garnett,211,108,NaN,1976,1509,51370,10648,21448,4923,6235,175,639,10473,20809,3257,11716,14973,5522,1905,2054,3225,3670,26394
Kevin Grevey,196,95,University of Kentucky,1953,78,1182,190,424,88,107,8,33,182,391,27,76,103,94,30,2,55,85,476
Kevin Henderson,193,88,"California State University, Fullerton",1964,39,425,45,114,32,54,0,2,45,112,19,26,45,57,17,0,38,61,122
Kevin Johnson,203,108,Michigan State University,1962,815,26978,4787,9756,4120,4902,165,548,4622,9208,523,2072,2595,7148,1185,200,2404,1696,13859
Kevin Jones,203,113,West Virginia University,1989,32,334,43,107,9,15,0,0,43,107,38,40,78,10,9,5,8,25,95
Kevin Love,208,113,"University of California, Los Angeles",1988,576,18774,3510,7934,2686,3276,887,2435,2623,5499,1784,4828,6612,1368,404,275,1139,1235,10593
Kevin Lynch,196,88,University of Minnesota,1968,95,1143,123,282,61,84,3,9,120,273,42,78,120,108,48,15,68,151,310
Kevin Martin,206,106,University of Cincinnati,1977,815,24287,4292,9909,4012,4603,1260,3315,3032,6594,444,2108,2552,1521,715,87,1346,1540,13856
Kevin McHale*,208,95,University of Minnesota,1957,643,21219,4940,8845,2810,3439,40,151,4900,8694,1589,3455,5044,1316,230,1036,1337,1750,12730
Kevin McKenna,196,88,Creighton University,1959,146,2300,318,746,130,155,100,262,218,484,54,139,193,214,128,18,122,313,866
Kevin Murphy,196,83,Tennessee Technological University,1990,17,52,7,28,0,0,1,5,6,23,0,4,4,2,1,0,3,4,15
Kevin Ollie,193,88,University of Connecticut,1972,938,15344,1298,3158,1235,1577,13,41,1285,3117,221,1304,1525,2297,512,34,766,1150,3844
Kevin Pritchard,190,81,University of Kansas,1967,113,1319,132,330,110,140,10,51,122,279,17,85,102,186,39,14,94,168,384
Kevin Salvadori,213,104,University of North Carolina,1970,39,241,13,46,16,24,0,0,13,46,11,34,45,13,2,24,17,29,42
Kevin Seraphin,206,129,NaN,1989,423,6430,1134,2318,248,347,0,7,1134,2311,502,960,1462,246,88,304,449,903,2516
Kevin Thompson,211,117,North Carolina State University,1971,14,58,6,14,1,2,0,1,6,13,7,6,13,3,0,2,5,11,13
Kevin Williams,188,79,St. John's University,1961,291,3294,551,1280,297,370,3,31,548,1249,183,230,413,329,189,41,284,629,1402
Kevin Willis,188,79,St. John's University,1961,1644,44717,8197,16989,3484,4884,45,220,8152,16769,4744,9059,13803,1517,1107,879,2930,4856,19923
Kevinn Pinkney,208,111,"University of Nevada, Reno",1983,6,100,12,27,6,9,1,2,11,25,7,8,15,5,3,3,4,12,31
Kevon Looney,206,99,"University of California, Los Angeles",1996,58,468,60,114,21,34,3,11,57,103,48,86,134,29,14,17,18,66,144
Keyon Dooling,190,88,University of Missouri,1980,728,14134,1810,4356,1001,1253,446,1277,1364,3079,132,832,964,1601,463,75,803,1221,5067
Khalid El-Amin,178,90,University of Connecticut,1979,50,936,115,311,56,72,28,84,87,227,21,60,81,145,48,2,54,99,314
Khalid Reeves,190,90,University of Arizona,1972,391,8102,1023,2485,570,766,346,965,677,1520,215,563,778,1230,305,44,617,903,2962
Khris Middleton,203,106,Texas A&M University,1991,296,9054,1501,3339,637,729,431,1068,1070,2271,167,965,1132,809,392,61,492,762,4070
Kiki Vandeweghe,203,99,"University of California, Los Angeles",1958,562,15661,3668,7188,2104,2383,210,539,3458,6649,476,839,1315,955,287,113,743,920,9650
Kim English,198,90,University of Missouri,1988,41,407,42,112,21,29,14,50,28,62,8,29,37,26,16,3,19,46,119
Kirk Haston,206,109,Indiana University,1979,27,134,13,56,6,12,0,6,13,50,5,22,27,8,0,6,10,19,32
Kirk Hinrich,193,86,University of Kansas,1981,997,29803,3830,9274,1537,1912,1271,3372,2559,5902,339,2489,2828,4606,1062,262,1768,2736,10468
Kirk Penney,196,99,University of Wisconsin,1980,6,30,2,9,0,0,1,4,1,5,0,2,2,2,1,0,5,1,5
Kirk Snyder,198,102,"University of Nevada, Reno",1983,247,4301,585,1305,327,464,97,304,488,1001,182,435,617,305,106,84,258,383,1594
Kiwane Garris,188,83,University of Illinois at Urbana-Champaign,1974,31,248,24,75,19,25,5,15,19,60,3,17,20,30,7,1,16,22,72
Klay Thompson,201,97,Washington State University,1990,464,15182,3282,7243,962,1128,1328,3171,1954,4072,205,1349,1554,1045,422,251,810,1039,8854
Kobe Bryant,198,96,NaN,1978,1346,48637,11719,26200,8378,10011,1827,5546,9892,20654,1499,5548,7047,6306,1944,640,4010,3353,33643
Korleone Young,201,96,NaN,1978,3,15,5,10,2,2,1,4,4,6,2,2,4,1,0,0,1,3,13
Kornel David,206,106,NaN,1971,168,2268,293,659,204,249,0,7,293,652,152,287,439,88,69,31,136,256,790
Kosta Koufos,213,120,Ohio State University,1989,623,9812,1523,2885,394,655,0,6,1523,2879,1054,1879,2933,243,239,481,434,1243,3440
Kosta Perovic,218,108,NaN,1985,7,38,3,10,4,6,0,0,3,10,6,7,13,1,0,2,1,6,10
Kostas Papanikolaou,203,102,NaN,1990,69,1089,93,263,22,32,41,138,52,125,47,111,158,101,42,18,76,95,249
Kris Dunn,193,95,Providence College,1994,78,1333,118,313,36,59,21,73,97,240,24,142,166,188,78,36,89,178,293
Kris Humphries,206,106,University of Minnesota,1985,922,16288,2379,5189,1333,1900,89,297,2290,4892,1564,3346,4910,624,378,525,795,1695,6180
Kris Joseph,201,95,Syracuse University,1988,20,108,4,28,10,16,0,6,4,22,2,12,14,2,6,0,4,6,18
Kristaps Porzingis,221,108,NaN,1995,138,4211,816,1871,399,492,193,557,623,1314,243,758,1001,191,100,264,239,449,2224
Kurk Lee,190,86,Towson University,1967,48,265,19,71,25,28,3,15,16,56,7,23,30,34,11,2,20,39,66
Kurt Nimphius,208,98,Arizona State University,1958,484,9871,1374,2830,732,1017,0,22,1374,2808,684,1218,1902,416,162,518,522,1294,3480
Kurt Rambis,203,96,Santa Clara University,1958,837,15345,1643,3124,909,1293,0,16,1643,3108,1511,3057,4568,939,709,358,901,1858,4195
Kurt Thomas,206,104,Texas Christian University,1972,1180,28744,4031,8290,1345,1781,9,33,4022,8257,2052,5783,7835,1271,780,898,1287,3767,9416
Kwame Brown,211,122,NaN,1982,645,14102,1590,3230,1038,1848,1,9,1589,3221,1136,2385,3521,599,346,399,822,1467,4219
Kyle Anderson,206,104,"University of California, Los Angeles",1993,183,2623,262,593,116,154,30,88,232,505,63,461,524,242,126,62,108,188,670
Kyle Korver,201,96,Creighton University,1981,1173,30800,4048,9107,1295,1465,2322,5409,1726,3698,342,3212,3554,2088,798,402,1272,2507,11713
Kyle Lowry,183,92,Villanova University,1986,790,23737,3462,8146,2660,3329,1162,3219,2300,4927,623,2476,3099,4398,1049,208,1699,2088,10746
Kyle Macy,190,79,University of Kentucky,1957,223,5694,732,1515,234,271,95,272,637,1243,99,371,470,1023,225,21,286,465,1793
Kyle O'Quinn,208,113,Norfolk State University,1990,321,4643,750,1494,241,328,19,86,731,1408,444,1017,1461,378,137,306,307,663,1760
Kyle Singler,203,103,Duke University,1988,424,9478,1008,2440,374,473,393,1062,615,1378,349,861,1210,355,249,131,330,883,2783
Kyle Weaver,198,91,Washington State University,1986,73,1379,134,304,53,72,42,119,92,185,34,124,158,119,55,33,80,97,363
Kyle Wiltjer,208,108,Gonzaga University,1992,14,44,4,14,1,2,4,13,0,1,4,6,10,2,3,1,5,4,13
Kyrie Irving,190,87,Duke University,1992,381,13024,3009,6588,1491,1708,723,1887,2286,4701,281,1009,1290,2114,504,127,1031,829,8232
Kyrylo Fesenko,216,130,NaN,1986,135,1107,125,252,55,134,0,2,125,250,97,172,269,40,19,53,66,224,305
LaBradford Smith,203,97,Alcorn State University,1958,249,4008,609,1428,280,351,52,164,557,1264,124,231,355,503,182,20,266,468,1550
LaMarcus Aldridge,211,117,University of Texas at Austin,1985,794,27568,6157,12659,2738,3412,84,293,6073,12366,2086,4504,6590,1510,611,828,1243,2005,15136
LaMark Baker,185,79,Ohio State University,1969,1,2,0,1,0,0,0,0,0,1,0,0,0,0,0,0,1,0,0
LaPhonso Ellis,203,108,University of Notre Dame,1970,624,17616,2895,6409,1379,1888,241,797,2654,5612,1320,2712,4032,981,433,477,1001,1934,7410
LaSalle Thompson,208,111,University of Texas at Austin,1961,936,20805,3075,6321,1512,2002,4,26,3071,6295,1961,4396,6357,1103,712,866,1570,2948,7666
Lamar Odom,208,99,University of Rhode Island,1979,961,32131,4811,10393,2495,3599,664,2126,4147,8267,1821,6238,8059,3554,848,892,2253,2916,12781
Lamar Patterson,196,102,University of Pittsburgh,1991,40,435,31,95,18,25,13,55,18,40,5,52,57,45,10,2,27,51,93
Lamond Murray,201,107,University of California,1973,736,18477,3137,7301,1484,1955,528,1466,2609,5835,936,2097,3033,978,684,319,1207,1471,8286
Lamont Strothers,193,86,Christopher Newport University,1968,13,155,24,73,10,14,2,15,22,58,9,6,15,14,9,1,17,15,60
Lanard Copeland,198,86,Georgia State University,1965,33,158,38,91,13,16,1,7,37,84,5,12,17,14,3,1,23,17,90
Lancaster Gordon,190,83,University of Louisville,1962,201,2581,472,1208,158,206,23,85,449,1123,116,143,259,294,128,31,237,266,1125
Lance Allred,211,113,Weber State University,1981,3,10,1,4,1,2,0,0,1,4,0,1,1,0,0,0,0,1,3
Lance Blanks,193,86,University of Texas at Austin,1966,142,1045,116,266,38,57,19,75,97,191,31,79,110,117,39,8,63,122,289
Lance Stephenson,196,104,University of Cincinnati,1990,445,10626,1533,3370,493,701,242,768,1291,2602,282,1478,1760,1273,294,60,739,869,3801
Lance Thomas,203,106,Duke University,1988,335,6579,742,1751,386,493,96,239,646,1512,291,620,911,258,138,42,270,556,1966
Landry Fields,201,95,Stanford University,1988,255,6010,684,1446,243,365,120,361,564,1085,248,844,1092,419,212,45,270,310,1731
Langston Galloway,188,90,Saint Joseph's University,1991,275,6480,849,2189,251,320,379,1016,470,1173,134,656,790,543,221,46,214,498,2328
Lari Ketner,206,125,University of Massachusetts Amherst,1977,47,271,26,64,16,24,0,0,26,64,24,44,68,3,8,6,22,40,68
Laron Profit,196,92,University of Maryland,1977,135,1537,173,413,74,104,21,89,152,324,52,157,209,166,70,25,116,138,441
Larry Bird*,206,99,Indiana State University,1956,498,19316,4963,9931,2323,2564,520,1308,4443,8623,776,3948,4724,3449,817,433,1533,1123,12769
Larry Drew,185,77,University of Missouri,1958,421,9982,1700,3658,569,714,105,361,1595,3297,129,529,658,1911,352,17,784,647,4074
Larry Hughes,196,83,Saint Louis University,1979,977,29306,4863,12091,2882,3786,738,2347,4125,9744,929,2990,3919,2932,1430,329,2011,2141,13346
Larry Johnson,190,92,University of Kentucky,1954,707,25685,4401,9086,2281,2978,367,1104,4034,7982,1794,3506,5300,2298,515,258,1435,1893,11450
Larry Krystkowiak,206,99,University of Montana,1964,420,9097,1294,2830,832,1046,5,36,1289,2794,643,1408,2051,513,264,62,522,1048,3425
Larry Micheaux,206,99,University of Houston,1960,114,1130,182,314,58,86,0,6,182,308,124,162,286,60,40,42,72,150,422
Larry Nance,208,92,Clemson University,1959,869,28789,5789,10696,2817,3653,20,96,5769,10600,2152,4844,6996,2247,844,1787,1492,2521,14415
Larry Owens,201,95,Oral Roberts University,1983,31,361,34,75,11,22,14,31,20,44,4,39,43,20,18,11,12,46,93
Larry Robinson,190,81,Centenary College of Louisiana,1968,159,2259,282,732,80,117,94,251,188,481,113,192,305,153,100,7,118,202,738
Larry Sanders,211,106,Virginia Commonwealth University,1988,238,4635,669,1395,182,329,0,5,669,1390,475,870,1345,174,152,429,224,666,1520
Larry Smith,203,97,Alcorn State University,1958,603,14564,1571,2995,454,903,0,6,1571,2989,2198,2963,5161,647,467,298,822,1899,3596
Larry Spriggs,201,104,Howard University,1959,118,1763,282,546,150,195,0,4,282,542,105,203,308,181,65,22,169,273,714
Larry Stewart,203,99,Coppin State University,1968,270,5415,765,1503,466,619,9,44,756,1459,444,633,1077,338,147,106,346,580,2005
Larry Sykes,206,115,Xavier University,1973,1,2,0,0,0,0,0,0,0,0,1,1,2,0,0,0,1,0,0
Latrell Sprewell,196,86,University of Alabama,1970,913,35270,6076,14294,3456,4298,1104,3272,4972,11022,770,2954,3724,3664,1294,399,2450,1689,16712
Lavor Postell,196,97,St. John's University,1978,61,446,59,176,66,83,11,44,48,132,11,34,45,13,12,2,35,28,195
Lavoy Allen,206,117,Temple University,1989,453,7977,962,2058,222,327,4,28,958,2030,834,1321,2155,455,144,247,301,832,2150
Lawrence Funderburke,206,104,Ohio State University,1970,318,4726,812,1606,405,600,2,17,810,1589,447,695,1142,183,94,100,225,360,2031
Lawrence Moten,196,83,Syracuse University,1972,119,1814,286,701,116,178,59,197,227,504,80,101,181,182,77,32,126,143,747
Lawrence Roberts,206,108,Mississippi State University,1982,87,1150,114,252,106,154,0,4,114,248,127,183,310,35,44,15,41,163,334
Lazar Hayward,198,102,Marquette University,1986,72,591,70,202,46,60,21,78,49,124,25,65,90,35,17,8,28,65,207
Lazaro Borrell,203,99,NaN,1972,17,167,28,63,6,11,0,3,28,60,14,26,40,10,6,3,6,9,62
LeBron James,203,113,NaN,1984,1061,41272,10423,20803,6474,8752,1467,4295,8956,16508,1289,6418,7707,7461,1749,817,3619,1977,28787
LeRon Ellis,208,95,St. John's University,1940,91,857,110,254,57,93,0,0,110,254,87,133,220,29,25,37,35,105,277
Leandro Barbosa,190,87,NaN,1982,914,19768,3674,8046,1342,1635,1053,2726,2621,5320,352,1496,1848,1871,749,128,1155,1786,9743
Ledell Eackles,196,99,University of New Orleans,1966,441,8917,1810,4071,1026,1338,137,408,1673,3663,362,617,979,740,249,31,600,794,4783
Lee Mayberry,185,78,University of Arkansas,1970,496,10337,950,2287,267,405,379,1006,571,1281,142,500,642,1767,352,43,591,865,2546
Lee Nailon,206,107,Texas Christian University,1975,363,6600,1268,2693,426,540,1,12,1267,2681,443,636,1079,336,148,61,365,689,2963
Leo Rautins,203,97,Syracuse University,1960,4,12,0,2,0,0,0,0,0,2,1,1,2,3,0,0,1,3,0
Leon Powe,203,108,University of California,1984,269,3648,549,1071,544,811,0,7,549,1064,404,570,974,85,79,86,201,547,1642
Leon Smith,208,106,NaN,1980,15,104,11,28,11,17,0,0,11,28,11,22,33,3,5,1,3,13,33
Leon Wood,190,83,"California State University, Fullerton",1962,394,6638,918,2303,572,725,266,771,652,1532,116,347,463,1223,187,5,379,409,2674
Leonard Taylor,203,99,University of California,1966,10,37,0,6,11,16,0,1,0,5,4,8,12,1,0,0,5,4,11
Les Jepsen,213,107,University of Iowa,1967,52,192,20,60,13,20,0,2,20,58,29,38,67,2,2,8,6,33,53
Lester Conner,193,81,Oregon State University,1959,604,11989,1230,2792,840,1100,21,104,1209,2688,453,994,1447,2180,892,47,730,794,3321
Lester Hudson,190,86,University of Tennessee at Martin,1984,98,1059,178,468,95,116,49,181,129,287,30,111,141,120,54,14,102,90,500
Lewis Lloyd,198,92,Drake University,1959,238,5506,1274,2404,443,574,6,30,1268,2374,282,357,639,692,200,57,463,505,2997
Linas Kleiza,203,111,University of Missouri,1985,409,8185,1268,2912,638,836,387,1154,881,1758,388,1082,1470,321,159,73,409,886,3561
Lindsey Hunter,188,77,Jackson State University,1970,937,23253,2970,7663,941,1261,1075,2984,1895,4679,438,1583,2021,2506,1120,165,1159,1857,7956
Linton Johnson,203,92,Tulane University,1980,205,2753,313,753,92,132,47,146,266,607,207,430,637,85,97,76,135,350,765
Linton Townes,201,86,James Madison University,1959,1,8,0,6,2,2,0,0,0,6,1,0,1,0,0,0,0,1,2
Lionel Chalmers,183,81,Xavier University,1980,36,433,42,125,15,24,12,49,30,76,4,27,31,51,13,0,24,30,111
Lionel Hollins,190,83,Arizona State University,1953,80,1950,249,540,108,136,3,13,246,527,33,140,173,417,78,10,170,187,609
Lionel Simmons,201,95,La Salle University,1968,454,13472,2242,5179,1306,1694,43,141,2199,5038,798,2035,2833,1498,514,361,982,1106,5833
Litterial Green,185,83,University of Georgia,1970,148,1189,144,343,133,200,2,26,142,317,24,51,75,182,49,6,78,124,423
Lloyd Daniels,201,92,Mount San Antonio College,1967,252,4463,669,1701,180,239,199,651,470,1050,231,315,546,378,134,74,256,379,1717
Logan Vander,203,97,University of Wisconsin-Green Bay,1971,15,31,3,14,3,4,0,5,3,9,1,5,6,1,0,0,0,4,9
Lonnie Shelton,203,108,Oregon State University,1955,101,1926,250,551,65,93,0,7,250,544,120,290,410,157,65,22,122,315,565
Lonny Baxter,203,117,University of Maryland,1979,265,3050,395,843,214,327,2,8,393,835,287,494,781,64,65,96,166,503,1006
Loren Meyer,208,116,Iowa State University,1972,194,2752,368,846,163,232,12,30,356,816,224,401,625,96,42,65,195,496,911
Loren Woods,216,111,University of Arizona,1978,215,2428,208,496,138,215,1,7,207,489,263,419,682,74,55,128,138,278,555
Lorenzen Wright,188,92,Colorado State University,1945,796,18696,2562,5594,1080,1676,2,29,2560,5565,1696,3285,4981,626,474,575,881,2307,6206
Lorenzo Brown,196,85,North Carolina State University,1990,63,834,86,233,24,36,10,66,76,167,22,83,105,142,44,10,55,72,206
Lorenzo Charles,201,102,North Carolina State University,1963,36,273,49,88,24,36,0,0,49,88,13,26,39,8,2,6,18,37,122
Lorenzo Romar,185,79,University of Washington,1958,18,102,6,32,10,10,0,6,6,26,0,0,0,24,8,0,10,14,22
Lorenzo Williams,206,90,Stetson University,1969,318,6430,404,867,95,250,0,3,404,864,805,1070,1875,277,157,413,266,853,903
Lou Amundson,206,99,"University of Nevada, Las Vegas",1982,550,7090,811,1751,331,760,0,4,811,1747,827,1171,1998,278,200,389,399,1078,1953
Lou Roe,201,99,University of Massachusetts Amherst,1972,66,479,46,138,33,51,5,20,41,118,37,55,92,21,13,9,28,52,130
Lou Williams,206,90,Stetson University,1969,863,20430,3628,8666,3078,3694,1112,3193,2516,5473,309,1531,1840,2514,772,159,1308,1155,11446
Louis Orr,203,79,Syracuse University,1958,247,6309,884,1946,613,800,2,20,882,1926,409,560,969,432,214,71,340,522,2383
Loy Vaught,206,104,University of Michigan,1968,740,17542,3141,6243,849,1182,21,86,3120,6157,1533,3521,5054,675,531,235,848,1698,7152
Luc Longley,218,120,University of New Mexico,1969,643,13508,1904,4112,810,1072,0,6,1904,4106,1001,2226,3227,945,323,628,1061,1946,4618
Luc Mbah,201,99,NaN,1984,685,15391,1596,3533,781,1183,146,455,1450,3078,996,1759,2755,567,567,251,616,1202,4119
Lucas Nogueira,213,109,NaN,1992,92,1336,133,208,54,86,4,15,129,193,102,198,300,50,66,102,59,172,324
Lucious Harris,196,86,"California State University, Long Beach",1970,800,15701,2194,5151,994,1258,402,1155,1792,3996,554,1310,1864,1130,556,86,594,1013,5784
Luigi Datome,203,97,NaN,1987,76,656,120,275,10,12,43,119,77,156,20,84,104,29,10,15,29,50,293
Luis Flores,188,90,Manhattan College,1981,32,154,28,58,4,4,10,20,18,38,2,4,6,22,4,0,22,18,70
Luis Montero,201,83,Westchester CC,1993,12,42,5,19,3,4,1,9,4,10,0,4,4,1,0,0,4,1,14
Luis Scola,206,108,NaN,1980,743,19001,3669,7442,1452,1961,92,271,3577,7171,1335,3606,4941,1194,474,224,1121,2037,8882
Luke Babbitt,206,102,"University of Nevada, Reno",1989,331,4617,559,1378,107,144,334,823,225,555,105,646,751,193,82,51,146,466,1559
Luke Harangody,203,111,University of Notre Dame,1988,119,1511,181,477,47,64,37,153,144,324,100,239,339,66,36,37,36,177,446
Luke Jackson,206,108,University of Texas-Pan American,1941,86,862,103,278,57,80,37,106,66,172,29,70,99,71,29,4,56,86,300
Luke Ridnour,188,79,University of Oregon,1981,891,22764,3059,7130,1307,1522,621,1782,2438,5348,386,1588,1974,3889,846,169,1415,1871,8046
Luke Schenscher,216,115,Georgia Institute of Technology,1982,31,267,23,49,9,20,0,0,23,49,18,36,54,8,3,7,9,46,55
Luke Walton,203,106,University of Arizona,1980,594,10049,1074,2514,367,513,189,578,885,1936,494,1143,1637,1352,318,103,624,851,2704
Luke Zeller,211,111,University of Notre Dame,1987,16,58,9,26,0,0,1,5,8,21,1,9,10,3,0,0,0,5,19
Luol Deng,206,99,Duke University,1985,942,32749,5441,11997,2630,3408,701,2127,4740,9870,1541,4215,5756,2206,926,445,1558,1586,14213
Luther Head,190,83,University of Illinois at Urbana-Champaign,1982,380,8295,1080,2570,360,465,471,1216,609,1354,116,781,897,805,271,45,462,547,2991
Luther Wright,218,122,Seton Hall University,1971,15,92,8,23,3,4,0,1,8,22,6,4,10,0,1,2,6,21,19
Lynn Greer,188,79,Temple University,1979,41,432,61,141,27,32,18,52,43,89,2,25,27,53,17,1,18,32,167
M.L. Carr,183,74,NaN,1947,47,397,62,149,17,17,9,23,53,126,21,22,43,24,21,6,24,44,150
Maalik Wayns,188,90,Villanova University,1991,56,413,53,178,34,38,14,62,39,116,2,14,16,56,14,0,30,56,154
Maceo Baston,206,97,University of Michigan,1975,105,831,106,172,71,96,3,8,103,164,56,119,175,26,24,43,54,140,286
Maciej Lampe,211,124,NaN,1985,107,1040,145,374,40,61,4,12,141,362,65,175,240,35,13,17,55,134,334
Magic Johnson*,201,98,"University of California, Los Angeles",1956,568,20614,3888,7666,3492,3992,303,947,3585,6719,769,2949,3718,6814,876,176,2165,1140,11571
Mahmoud Abdul-Rauf,188,83,"University of California, Los Angeles",1942,586,15628,3514,7943,1051,1161,474,1339,3040,6604,219,868,1087,2079,487,46,963,1106,8553
Major Jones,206,102,Albany State University,1953,47,418,48,87,33,51,0,0,48,87,48,80,128,15,9,14,35,58,129
Makhtar N'Diaye,203,111,University of North Carolina,1973,4,27,1,4,3,4,0,0,1,4,3,2,5,1,0,1,1,9,5
Malachi Richardson,198,92,Syracuse University,1996,22,198,28,68,15,19,8,28,20,40,3,20,23,11,5,1,8,23,79
Malcolm Brogdon,196,97,University of Virginia,1992,75,1982,290,635,109,126,78,193,212,442,47,166,213,317,84,12,113,140,767
Malcolm Delaney,190,86,Virginia Polytechnic Institute and State Unive...,1989,73,1248,145,388,75,93,26,110,119,278,11,113,124,193,39,1,95,112,391
Malcolm Lee,196,90,"University of California, Los Angeles",1990,36,534,52,136,26,37,10,34,42,102,24,41,65,51,20,10,27,52,140
Malcolm Mackey,206,112,Georgia Institute of Technology,1970,22,69,14,37,4,8,0,2,14,35,12,12,24,1,0,3,2,9,32
Malcolm Thomas,206,102,San Diego State University,1988,60,449,42,95,20,35,2,15,40,80,37,96,133,20,8,12,37,43,106
Malik Allen,208,115,Villanova University,1978,587,8877,1280,2869,302,378,4,18,1276,2851,572,1076,1648,290,158,273,383,1099,2866
Malik Beasley,196,88,Florida State University,1996,22,165,33,73,8,10,9,28,24,45,5,12,17,11,7,0,8,10,83
Malik Hairston,198,99,University of Oregon,1987,62,472,64,125,19,37,2,12,62,113,24,53,77,29,10,16,23,48,149
Malik Rose,201,113,Drexel University,1974,927,15349,2035,4676,1582,2129,15,96,2020,4580,1312,2496,3808,779,543,312,1197,2176,5667
Malik Sealy,203,86,St. John's University,1970,493,11720,1865,4375,1067,1319,158,541,1707,3834,505,1080,1585,816,518,157,681,1087,4955
Mamadou N'Diaye,203,111,University of North Carolina,1973,97,1224,112,268,136,184,0,1,112,267,131,206,337,8,25,89,58,205,360
Manny Harris,196,83,University of Michigan,1989,93,1594,199,524,124,168,53,150,146,374,57,196,253,129,48,14,101,104,575
Manu Ginobili,198,92,NaN,1977,992,25560,4383,9799,3270,3958,1431,3863,2952,5936,666,2889,3555,3838,1349,303,2011,2086,13467
Manute Bol,231,90,University of Bridgeport,1962,638,11814,669,1654,226,403,43,208,626,1446,599,2066,2665,172,128,2102,456,1470,1607
MarShon Brooks,196,90,Providence College,1989,199,3192,543,1225,246,330,88,255,455,970,122,290,412,257,114,39,235,251,1420
Marc Gasol,216,115,NaN,1985,643,21721,3604,7262,2268,2936,116,334,3488,6928,1184,3709,4893,2086,594,971,1294,1910,9592
Marc Iavaroni,203,95,University of Virginia,1956,510,7575,859,1882,518,745,0,19,859,1863,515,1084,1599,537,184,153,573,1175,2236
Marc Jackson,185,81,St. John's University,1965,490,9094,1428,3213,975,1198,8,34,1420,3179,764,1236,2000,369,171,116,562,970,3839
Marcelo Huertas,190,90,NaN,1983,76,1106,122,298,36,46,20,80,102,218,20,94,114,234,36,9,99,92,300
Marcin Gortat,211,108,NaN,1984,757,19897,3350,6025,1141,1668,4,24,3346,6001,1659,4495,6154,769,373,895,889,1696,7845
Marco Belinelli,196,95,NaN,1986,644,14903,2204,5191,948,1140,853,2262,1351,2929,144,1177,1321,1080,375,44,665,965,6209
Marcus Banks,188,90,"University of Nevada, Las Vegas",1981,464,7843,1067,2431,610,791,190,566,877,1865,128,589,717,1037,345,83,606,927,2934
Marcus Brown,190,83,Murray State University,1974,27,229,32,84,15,21,13,39,19,45,7,15,22,23,8,2,16,34,92
Marcus Camby,211,99,University of Massachusetts Amherst,1974,1106,32350,4133,8865,1817,2737,22,100,4111,8765,3017,7897,10914,2130,1112,2562,1510,2974,10105
Marcus Cousin,211,111,University of Houston,1986,4,18,2,3,0,0,0,0,2,3,0,3,3,0,0,1,1,1,4
Marcus Fizer,206,118,Iowa State University,1978,289,6032,1103,2536,555,803,21,110,1082,2426,375,965,1340,352,134,81,428,648,2782
Marcus Georges-Hunt,196,97,Georgia Institute of Technology,1994,5,48,2,7,9,10,1,2,1,5,1,8,9,3,1,0,2,5,14
Marcus Haislip,208,104,University of Tennessee,1980,89,854,125,286,54,82,7,20,118,266,51,80,131,16,15,34,39,100,311
Marcus Landry,201,104,University of Wisconsin,1985,36,222,32,86,6,10,18,56,14,30,10,28,38,0,2,4,12,28,88
Marcus Liberty,203,92,University of Illinois at Urbana-Champaign,1968,305,4853,823,2000,329,506,76,222,747,1778,444,542,986,261,200,77,288,529,2051
Marcus Morris,188,88,Northwestern University,1925,493,12440,1910,4472,678,970,611,1711,1299,2761,490,1554,2044,709,346,124,553,1015,5109
Marcus Smart,193,99,Oklahoma State University,1994,207,5874,628,1755,414,543,246,845,382,910,215,568,783,757,315,70,329,551,1916
Marcus Thornton,193,92,Louisiana State University,1987,737,16645,3082,7336,1115,1355,1077,3020,2005,4316,586,1454,2040,1010,601,92,729,1087,8356
Marcus Vinicius,206,97,NaN,1986,26,172,16,35,10,18,8,19,8,16,3,16,19,7,3,2,9,14,50
Marcus Webb,206,115,University of Alabama,1970,9,51,13,25,13,21,0,1,13,24,5,5,10,2,1,2,5,11,39
Marcus Williams,185,89,University of Alabama,1982,227,3170,439,1149,148,193,126,392,313,757,64,321,385,580,89,9,295,204,1152
Mardy Collins,198,99,Temple University,1984,237,3661,401,1025,140,233,51,158,350,867,122,321,443,438,141,32,261,336,993
Mario Bennett,198,106,Arizona State University,1973,68,606,111,208,46,90,1,3,110,205,84,98,182,24,31,22,33,112,269
Mario Chalmers,188,86,University of Kansas,1986,641,17197,1950,4642,1216,1531,748,2111,1202,2531,222,1363,1585,2445,959,102,1195,1758,5864
Mario Elie,196,95,American International College,1963,765,19298,2202,4651,1520,1781,578,1582,1624,3069,566,1561,2127,1920,690,139,990,1523,6502
Mario Hezonja,203,97,NaN,1995,144,2373,298,748,89,104,110,336,188,412,48,274,322,171,69,31,155,198,795
Mario Kasun,216,117,NaN,1980,73,569,78,167,42,66,0,1,78,166,76,112,188,11,10,16,41,155,198
Mario West,208,104,Old Dominion University,1960,162,796,56,125,40,71,2,10,54,115,60,82,142,51,45,8,31,134,154
Mark Acres,211,99,Oral Roberts University,1962,393,6251,540,1065,319,479,8,15,532,1050,607,985,1592,185,140,110,248,966,1407
Mark Aguirre,198,105,DePaul University,1959,792,23175,5714,11961,2890,3880,387,1229,5327,10732,1409,2329,3738,2295,535,262,1833,2183,14705
Mark Alarie,203,98,Duke University,1963,325,5500,1037,2184,324,418,34,135,1003,2049,438,682,1120,363,132,109,309,712,2432
Mark Blount,213,104,University of Pittsburgh,1975,767,17624,2543,5092,1133,1556,37,103,2506,4989,1102,2355,3457,668,409,652,1230,1995,6256
Mark Bradtke,208,120,NaN,1968,36,251,25,58,9,13,0,0,25,58,26,42,68,7,5,5,9,34,59
Mark Bryant,206,111,Seton Hall University,1965,813,13579,1744,3500,837,1200,1,12,1743,3488,1128,1884,3012,495,331,196,668,2036,4326
Mark Davis,198,88,Old Dominion University,1963,296,4197,571,1275,343,506,30,134,541,1141,323,448,771,322,226,85,348,559,1515
Mark Eaton,224,124,"University of California, Los Angeles",1957,712,21502,1732,3757,940,1440,0,0,1732,3757,1623,4259,5882,615,319,2438,1055,2395,4404
Mark Hendrickson,206,99,Washington State University,1974,129,1579,139,330,113,141,3,18,136,312,101,228,329,69,52,16,66,147,394
Mark Jackson,185,81,St. John's University,1965,1461,44763,5326,11993,2410,3124,870,2598,4456,9395,1435,4228,5663,11930,1789,136,3604,2530,13932
Mark Jones,206,102,Albany State University,1953,10,116,9,31,5,10,0,4,9,27,6,7,13,6,5,2,3,16,23
Mark Macon,196,83,Temple University,1969,293,5514,763,1990,286,392,36,136,727,1854,191,317,508,479,388,21,363,660,1848
Mark Madsen,206,108,Stanford University,1976,453,5335,381,834,212,402,1,16,380,818,559,598,1157,181,116,102,206,866,975
Mark McNamara,211,106,University of California,1959,217,1761,216,466,194,327,0,0,216,466,205,303,508,45,25,32,117,221,626
Mark Olberding,203,102,University of Minnesota,1956,238,5436,559,1096,571,693,0,6,559,1090,302,819,1121,600,117,43,389,718,1689
Mark Pope,208,106,University of Kentucky,1972,153,1634,116,289,43,75,10,56,106,233,92,169,261,63,32,45,47,242,285
Mark Price,183,77,Georgia Institute of Technology,1964,722,21560,3939,8345,2135,2362,976,2428,2963,5917,409,1439,1848,4863,860,76,1790,964,10989
Mark Randall,203,106,University of Kansas,1967,218,1572,236,518,118,166,10,63,226,455,145,141,286,100,40,13,95,167,600
Mark Strickland,206,95,Temple University,1970,336,4134,642,1344,246,371,3,11,639,1333,322,610,932,126,95,132,197,393,1533
Mark Wade,180,72,"University of Nevada, Las Vegas",1965,12,126,3,20,2,4,0,2,3,18,3,12,15,36,7,1,13,13,8
Mark West,208,104,Old Dominion University,1960,1205,22997,2935,5081,1409,2467,0,6,2935,5075,2021,4054,6075,504,385,1584,1428,3543,7279
Markel Brown,190,83,Murray State University,1974,109,1763,203,532,118,151,55,185,148,347,39,190,229,130,69,27,81,151,579
Markieff Morris,188,88,Northwestern University,1925,512,13430,2379,5359,1001,1301,344,1051,2035,4308,702,2160,2862,883,485,306,890,1487,6103
Marko Jaric,201,89,NaN,1978,447,11246,1190,2944,524,718,289,840,901,2104,274,926,1200,1600,583,128,708,967,3193
Marko Milic,198,106,NaN,1977,44,216,47,84,11,17,3,7,44,77,13,17,30,14,13,1,27,24,108
Marlon Garnett,188,84,Santa Clara University,1975,24,205,15,51,15,20,6,23,9,28,3,18,21,18,5,1,12,18,51
Marlon Maxey,203,113,University of Texas at El Paso,1969,98,1146,182,336,115,168,0,3,182,333,141,222,363,22,27,51,78,188,479
Marques Bragg,203,104,Providence College,1970,53,369,54,120,23,41,0,0,54,120,38,41,79,8,17,8,26,71,131
Marques Johnson,201,98,"University of California, Los Angeles",1956,167,5454,1187,2482,532,711,6,37,1181,2445,361,533,894,568,191,86,386,443,2912
Marquese Chriss,208,105,University of Washington,1997,82,1743,284,632,113,181,72,224,212,408,96,252,348,60,67,70,108,263,753
Marquis Daniels,198,90,Auburn University,1981,548,11707,1772,3933,672,932,103,439,1669,3494,521,1031,1552,966,509,137,644,882,4319
Marquis Teague,188,85,University of Kentucky,1993,128,1278,119,351,61,86,14,59,105,292,5,119,124,179,29,17,113,139,313
Marreese Speights,208,115,University of Florida,1987,732,11265,2303,4985,1093,1372,149,428,2154,4557,1072,2056,3128,469,205,387,654,1633,5848
Marshall Plumlee,211,111,Duke University,1990,21,170,16,30,8,19,0,0,16,30,23,28,51,10,4,4,12,23,40
Martell Webster,216,102,Morgan State University,1952,580,13914,1696,4062,874,1105,790,2067,906,1995,352,1459,1811,588,299,160,536,1055,5056
Martin Lewis,196,95,Seward County Community College,1975,25,239,35,74,16,27,3,10,32,64,19,16,35,7,9,5,15,29,89
Martin Muursepp,206,106,NaN,1974,125,1299,191,453,139,207,24,86,167,367,116,132,248,70,53,36,65,212,545
Martin Nessley,218,117,Duke University,1965,88,672,40,104,16,36,0,0,40,104,46,118,164,32,16,24,46,178,96
Marty Conlon,208,101,Providence College,1968,409,6895,1062,2107,548,740,15,77,1047,2030,551,898,1449,412,157,81,446,753,2687
Martynas Andriuskevicius,218,108,NaN,1986,6,9,0,1,0,0,0,0,0,1,1,3,4,0,2,0,0,1,0
Marvin Webster,216,102,Morgan State University,1952,15,102,10,19,6,8,1,1,9,18,12,14,26,3,3,7,8,17,27
Marvin Williams,185,89,University of Alabama,1982,861,24891,3276,7390,1846,2288,724,2051,2552,5339,1096,3488,4584,1125,661,448,875,1780,9122
Mason Plumlee,211,111,Duke University,1990,396,9398,1414,2554,842,1447,0,22,1414,2532,815,1845,2660,928,320,387,607,1083,3670
Mateen Cleaves,188,92,Michigan State University,1977,167,1863,233,599,131,180,12,45,221,554,33,142,175,310,67,5,201,213,609
Matt Barnes,203,95,Providence College,1952,1059,24375,3043,7001,1133,1520,1072,3209,1971,3792,1184,3608,4792,1912,782,477,1309,2638,8291
Matt Bonner,208,106,University of Florida,1980,792,13356,1749,3768,337,432,797,1923,952,1845,622,1749,2371,552,285,213,299,1307,4632
Matt Bullard,208,97,University of Iowa,1967,615,8884,1215,2907,241,314,599,1561,616,1346,278,945,1223,535,186,119,319,775,3270
Matt Carroll,198,96,University of Notre Dame,1980,530,8276,1102,2683,634,755,358,952,744,1731,155,783,938,342,245,66,336,779,3196
Matt Fish,211,106,University of North Carolina at Wilmington,1969,74,654,93,181,45,75,0,1,93,180,54,82,136,33,22,21,38,112,231
Matt Freije,208,108,Vanderbilt University,1981,42,588,53,181,10,14,17,76,36,105,24,61,85,27,16,3,20,53,133
Matt Geiger,213,110,Georgia Institute of Technology,1969,552,12221,2039,4083,965,1325,16,69,2023,4014,1152,2006,3158,388,306,347,744,1629,5059
Matt Harpring,201,104,Georgia Institute of Technology,1976,665,17584,2900,6033,1687,2239,158,474,2742,5559,1281,2085,3366,907,497,112,1000,1748,7645
Matt Maloney,190,87,University of Pennsylvania,1971,295,7470,783,1920,212,266,399,1073,384,847,62,438,500,852,240,14,381,376,2177
Matt Othick,188,74,University of Arizona,1969,4,39,3,5,0,2,2,4,1,1,1,1,2,7,1,0,4,7,8
Matt Steigenga,201,102,Michigan State University,1970,2,12,1,4,1,2,0,2,1,2,0,3,3,2,1,1,2,1,3
Matt Walsh,198,92,University of Florida,1982,2,3,1,1,0,2,0,0,1,1,0,0,0,0,0,0,1,0,2
Matt Wenstrom,216,113,University of North Carolina,1970,11,37,6,10,6,10,0,0,6,10,6,6,12,0,0,2,4,7,18
Matthew Dellavedova,193,89,Saint Mary's College of California,1990,291,6504,648,1648,206,248,302,776,346,872,123,435,558,1085,154,16,370,604,1804
Maurice Ager,196,91,Michigan State University,1984,108,670,85,254,36,65,14,63,71,191,12,47,59,27,6,7,35,82,220
Maurice Baker,185,79,Oklahoma State University,1979,10,38,0,2,0,0,0,0,0,2,2,2,4,2,2,0,2,6,0
Maurice Carter,196,95,Louisiana State University,1976,20,220,22,70,32,40,8,22,14,48,4,18,22,8,0,0,18,20,84
Maurice Cheeks,185,81,West Texas A&M University,1956,707,22460,3112,6046,1559,1899,34,155,3078,5891,410,1483,1893,4610,1320,137,1261,1085,7817
Maurice Evans,196,99,University of Texas at Austin,1978,710,14187,1868,4200,574,731,562,1548,1306,2652,703,1055,1758,546,374,112,351,1227,4872
Maurice Harkless,206,97,St. John's University,1993,356,8278,1056,2240,326,547,208,661,848,1579,455,871,1326,311,351,226,329,688,2646
Maurice Lucas,206,97,Marquette University,1952,276,5731,991,2141,589,765,1,14,990,2127,491,1254,1745,388,151,72,420,795,2572
Maurice Martin,198,90,Saint Joseph's University,1964,69,422,74,196,52,87,4,19,70,177,25,40,65,49,19,9,43,69,204
Maurice Ndour,206,90,Ohio University,1992,32,331,39,86,19,26,1,7,38,79,22,42,64,8,15,8,12,30,98
Maurice Taylor,206,117,University of Michigan,1976,599,14660,2674,5744,1005,1427,8,42,2666,5702,858,1851,2709,690,273,279,1067,1783,6361
McKinley Singleton,196,79,University of Alabama at Birmingham,1961,2,10,2,3,0,0,0,1,2,2,0,0,0,1,0,0,0,1,4
Mehmet Okur,211,112,NaN,1979,634,18429,3028,6615,1909,2396,596,1590,2432,5025,1261,3175,4436,1089,329,453,991,1815,8561
Mel McCants,203,108,Purdue University,1967,13,65,8,26,6,8,0,0,8,26,1,5,6,2,3,1,1,11,22
Melvin Booker,185,83,University of Missouri,1972,53,991,108,260,45,51,27,93,81,167,15,52,67,127,11,5,66,74,288
Melvin Ely,208,117,"California State University, Fresno",1978,405,6314,812,1782,457,729,0,3,812,1779,463,805,1268,279,105,217,420,816,2081
Melvin Newbern,193,90,University of Minnesota,1967,33,311,42,113,34,60,1,8,41,105,19,18,37,57,23,1,32,42,119
Melvin Sanders,196,95,Oklahoma State University,1981,16,113,16,33,7,10,2,3,14,30,4,19,23,3,5,0,8,20,41
Melvin Turpin,211,108,University of Kentucky,1960,361,6871,1297,2513,476,613,1,9,1296,2504,575,1080,1655,183,155,348,431,853,3071
Mengke Bateer,211,131,NaN,1975,46,494,61,156,29,39,5,15,56,141,39,75,114,27,11,5,40,118,156
Metta World,190,81,NaN,1974,1102,35289,5285,12769,2914,4105,1285,3825,4000,8944,1307,3698,5005,2961,1983,602,2040,2967,14769
Meyers Leonard,216,111,University of Illinois at Urbana-Champaign,1992,299,4963,658,1426,188,228,210,566,448,860,230,936,1166,246,49,103,215,712,1714
Michael Adams,178,73,Boston College,1963,653,20446,3257,7849,2158,2543,949,2857,2308,4992,416,1484,1900,4209,1081,67,1402,1193,9621
Michael Anderson,180,83,Drexel University,1966,36,730,73,175,57,82,1,7,72,168,44,45,89,153,44,3,84,64,204
Michael Ansley,201,102,University of Alabama,1967,159,2188,391,764,265,366,0,0,391,764,313,314,627,69,51,24,88,291,1047
Michael Beasley,206,106,Kansas State University,1989,509,11973,2604,5684,949,1252,254,732,2350,4952,554,1833,2387,640,301,261,855,1107,6411
Michael Bradley,208,111,Villanova University,1979,207,2233,240,496,49,98,2,15,238,481,237,405,642,99,29,49,125,226,531
Michael Brooks,201,99,La Salle University,1958,26,281,33,86,10,14,0,0,33,86,28,44,72,24,13,1,23,40,76
Michael Cage,206,101,San Diego State University,1962,1140,29716,3317,6445,1644,2476,0,25,3317,6420,3227,5419,8646,1057,1050,725,1161,2581,8278
Michael Carter-Williams,198,86,Syracuse University,1991,301,9207,1518,3753,826,1188,157,633,1361,3120,301,1270,1571,1719,470,167,972,811,4019
Michael Cooper,196,77,University of New Mexico,1956,467,12298,1465,3404,649,751,374,1062,1091,2342,300,1099,1399,2086,465,229,695,1173,3953
Michael Curry,196,95,Georgia Southern University,1968,713,13991,1167,2609,764,934,99,318,1068,2291,225,905,1130,831,357,68,483,1615,3197
Michael Dickerson,196,86,University of Arizona,1975,212,7490,1219,2824,531,677,288,717,931,2107,178,431,609,553,213,85,407,551,3257
Michael Doleac,211,118,University of Utah,1977,659,9818,1386,3160,434,544,1,8,1385,3152,670,1550,2220,387,223,245,424,1457,3207
Michael Finley,201,97,University of Wisconsin,1973,1232,41495,7252,16350,2666,3292,1587,4242,5665,12108,1215,4032,5247,3512,1074,353,1814,1983,18757
Michael Gbinije,201,90,Syracuse University,1992,9,32,1,10,2,2,0,4,1,6,2,1,3,2,0,0,0,2,4
Michael Hawkins,183,80,Xavier University,1972,75,641,49,130,16,20,18,59,31,71,21,47,68,117,21,2,50,69,132
Michael Jackson,201,97,"California State University, Los Angeles",1949,89,888,76,206,27,40,9,33,67,173,20,50,70,198,28,5,66,96,188
Michael Jordan*,198,88,University of North Carolina,1963,1072,41011,12192,24537,7327,8772,581,1778,11611,22759,1668,5004,6672,5633,2514,893,2924,2783,32292
Michael Kidd-Gilchrist,201,105,University of Kentucky,1993,283,7668,1000,2127,575,808,7,34,993,2093,517,1288,1805,369,211,227,288,620,2582
Michael McDonald,208,105,University of New Orleans,1969,1,4,0,0,0,0,0,0,0,0,1,0,1,0,0,0,2,1,0
Michael Olowokandi,213,122,University of the Pacific,1975,548,14048,1895,4349,583,983,0,0,1895,4349,1001,2633,3634,350,248,730,953,1640,4373
Michael Phelps,193,81,Alcorn State University,1961,132,1372,195,469,78,122,2,22,193,447,45,96,141,138,71,3,96,147,470
Michael Redd,198,99,Ohio State University,1979,629,20104,4207,9405,2513,2998,1045,2751,3162,6654,622,1789,2411,1338,579,66,963,1002,11972
Michael Ruffin,206,111,University of Tulsa,1977,414,5966,258,634,200,436,0,3,258,631,729,903,1632,250,199,193,273,942,716
Michael Smith,208,102,Brigham Young University,1965,638,12933,1337,2581,792,1407,10,68,1327,2513,1316,2395,3711,891,423,268,686,1351,3476
Michael Stewart,208,104,University of California,1975,311,3450,251,568,134,255,0,0,251,568,357,579,936,88,58,288,145,591,636
Michael Wilson,193,79,Marquette University,1959,52,624,78,174,58,76,0,0,78,174,30,40,70,84,30,10,50,62,214
Michael Young,201,99,University of Houston,1961,49,472,94,202,27,38,8,27,86,175,37,51,88,24,25,3,15,47,223
Micheal Ray,198,85,NaN,1955,129,4731,986,2131,381,492,33,142,953,1989,233,474,707,1009,368,33,399,440,2386
Micheal Williams,188,82,Lincoln University of Missouri,1945,441,10732,1530,3289,1581,1826,48,214,1482,3075,312,770,1082,2466,739,96,971,1112,4689
Mickael Gelabale,201,97,NaN,1983,145,2348,263,560,101,124,43,136,220,424,107,223,330,115,50,35,92,186,670
Mickael Pietrus,198,97,NaN,1982,614,13057,1768,4186,739,1110,764,2146,1004,2040,455,1394,1849,478,400,251,615,1371,5039
Mickell Gladness,211,99,Alabama A&M University,1986,52,504,50,118,12,24,0,0,50,118,28,88,116,10,8,40,14,64,112
Mickey Johnson,208,86,Aurora University,1952,145,3139,518,1221,443,549,12,54,506,1167,247,481,728,366,137,60,307,469,1491
Mike Batiste,203,102,Arizona State University,1977,75,1248,197,467,69,88,18,81,179,386,82,175,257,52,42,16,69,120,481
Mike Bibby,185,86,University of Arizona,1978,1129,37820,5906,13591,2478,3105,1763,4595,4143,8996,562,2896,3458,6072,1276,162,2354,2203,16053
Mike Bratz,188,83,Stanford University,1955,89,1015,132,320,83,100,10,40,122,280,13,68,81,161,60,4,71,119,357
Mike Brittain,213,106,University of South Carolina,1963,38,248,26,52,11,21,0,0,26,52,12,41,53,7,4,12,22,57,63
Mike Brown,206,116,George Washington University,1963,626,10961,1126,2476,877,1271,1,8,1125,2468,934,1828,2762,424,253,169,643,1372,3130
Mike Champion,208,104,Gonzaga University,1964,2,4,0,3,0,0,0,1,0,2,0,0,0,0,0,0,1,2,0
Mike Conley,185,79,Ohio State University,1987,706,22985,3628,8196,1887,2316,907,2391,2721,5805,300,1762,2062,4011,1055,137,1438,1401,10050
Mike Dunleavy,190,81,University of South Carolina,1954,1147,31242,4481,10147,2153,2684,1446,3876,3035,6271,806,3984,4790,2558,834,356,1594,2318,12561
Mike Evans,185,77,Kansas State University,1955,299,5049,1100,2412,365,440,185,593,915,1819,101,295,396,674,239,31,404,560,2750
Mike Gibson,208,92,University of South Carolina Upstate,1960,32,161,20,51,8,11,0,0,20,51,15,25,40,5,8,4,6,35,48
Mike Glenn,188,79,Southern Illinois University,1955,102,1733,327,591,114,132,0,2,327,589,24,116,140,162,37,3,73,119,768
Mike Gminski,211,113,Duke University,1959,846,24295,4246,9238,2454,2841,8,60,4238,9178,2013,4517,6530,1180,481,845,1213,1396,10954
Mike Hall,203,104,George Washington University,1984,2,13,1,4,0,0,0,0,1,4,1,1,2,1,0,0,0,1,2
Mike Harris,198,108,Rice University,1983,67,592,81,181,50,66,0,6,81,175,61,79,140,15,32,13,39,82,212
Mike Higgins,206,99,University of Northern Colorado,1967,29,161,12,26,20,27,0,0,12,26,8,5,13,8,4,6,6,26,44
Mike Holton,193,83,"University of California, Los Angeles",1961,353,6348,873,1980,424,535,29,121,844,1859,142,350,492,1032,233,30,436,624,2199
Mike Iuzzolino,178,79,Saint Francis University,1968,122,3049,381,833,221,277,113,280,268,553,58,180,238,522,82,7,221,180,1096
Mike James,188,85,Duquesne University,1975,865,20788,3040,7344,1217,1522,993,2634,2047,4710,314,1654,1968,2938,684,55,1255,1695,8290
Mike McGee,196,86,University of Michigan,1959,413,8116,1814,3897,455,730,356,1002,1458,2895,413,532,945,577,345,41,523,808,4439
Mike Miller,203,98,University of Florida,1980,1097,29998,4389,9606,1507,1943,1699,4210,2690,5396,679,4039,4718,2836,615,250,1686,2216,11984
Mike Mitchell,201,97,Auburn University,1956,272,8246,2163,4517,838,1044,9,49,2154,4468,371,756,1127,445,167,74,431,563,5173
Mike Morrison,193,88,Loyola College in Maryland,1967,36,153,23,68,24,30,2,7,21,61,7,13,20,11,2,0,23,20,72
Mike Muscala,211,108,Bucknell University,1991,190,2519,360,713,116,142,67,174,293,539,183,345,528,161,62,97,115,250,903
Mike O'Koren,201,93,University of North Carolina,1958,129,2325,379,787,65,112,15,51,364,736,86,233,319,235,66,27,111,261,838
Mike Penberthy,190,83,Master's College,1974,56,863,93,224,31,35,55,139,38,85,10,55,65,73,24,2,34,57,272
Mike Peplowski,208,122,Michigan State University,1970,75,722,87,156,27,52,0,1,87,155,52,128,180,27,20,29,40,161,201
Mike Sanders,198,95,"University of California, Los Angeles",1960,662,12928,2239,4603,844,1090,20,88,2219,4515,674,1261,1935,926,478,207,731,1731,5342
Mike Scott,203,107,University of Virginia,1988,281,4322,765,1663,264,336,194,578,571,1085,209,627,836,257,88,32,189,350,1988
Mike Smith,208,102,Brigham Young University,1965,17,180,19,59,10,16,3,18,16,41,10,12,22,10,5,3,7,8,51
Mike Smrek,213,113,Canisius College,1962,209,1985,220,516,138,226,0,2,220,514,153,295,448,53,40,153,141,444,578
Mike Sweetney,203,124,Georgetown University,1982,233,3610,564,1164,388,563,0,2,564,1162,400,645,1045,145,73,107,277,569,1516
Mike Taylor,188,74,Iowa State University,1986,51,771,110,267,56,81,13,40,97,227,22,65,87,106,36,0,73,84,289
Mike Tobey,213,117,University of Virginia,1994,2,25,1,4,0,0,0,0,1,4,2,1,3,1,0,0,1,2,2
Mike Wilks,178,83,Rice University,1979,341,3464,313,814,189,258,50,168,263,646,91,266,357,409,132,15,178,331,865
Mike Williams,188,82,Lincoln University of Missouri,1945,42,204,12,36,6,12,0,2,12,34,10,36,46,4,6,14,6,60,30
Mike Woodson,196,88,Indiana University,1958,485,12648,2718,6029,1321,1599,104,379,2614,5650,377,707,1084,1111,559,146,847,1173,6861
Mikki Moore,211,102,University of Nebraska,1975,674,11897,1438,2622,803,1071,2,13,1436,2609,888,1658,2546,484,203,342,609,1821,3681
Mile Ilic,216,104,NaN,1984,5,6,0,3,0,0,0,0,0,3,0,1,1,0,0,0,3,1,0
Miles Plumlee,211,112,Duke University,1988,391,6245,791,1499,205,365,0,0,791,1499,604,1106,1710,171,189,301,316,631,1787
Miles Simon,190,91,University of Arizona,1975,5,19,1,5,0,0,0,2,1,3,1,1,2,0,1,0,3,1,2
Milos Babic,213,108,Tennessee Technological University,1968,21,87,12,32,13,20,0,0,12,32,8,12,20,10,2,1,10,7,37
Milt Palacio,190,88,Colorado State University,1978,539,9211,945,2274,531,737,53,211,892,2063,170,734,904,1277,332,62,636,746,2474
Milt Wagner,196,83,University of Louisville,1963,53,496,86,204,35,40,8,27,78,177,4,31,35,76,8,7,34,56,215
Mindaugas Kuzminskas,206,97,NaN,1989,68,1016,158,369,55,68,54,168,104,201,47,79,126,69,29,11,51,79,425
Miroslav Raduljica,213,113,NaN,1988,53,488,71,134,47,57,0,0,71,134,56,57,113,23,8,13,30,92,189
Mirsad Turkcan,206,107,NaN,1976,34,180,28,76,10,16,0,12,28,64,26,40,66,10,6,2,16,28,66
Mirza Teletovic,206,109,NaN,1985,314,5606,902,2228,241,319,520,1415,382,813,186,833,1019,263,100,81,248,538,2565
Mitch Kupchak,206,104,University of North Carolina,1954,113,1499,247,501,144,203,0,1,247,500,137,238,375,38,31,27,112,206,638
Mitch McGary,208,115,University of Michigan,1992,52,557,99,188,29,50,0,6,99,182,57,126,183,17,17,18,38,82,227
Mitch Richmond*,196,97,Kansas State University,1965,976,34309,7305,16038,4561,5365,1326,3417,5979,12621,881,2920,3801,3398,1211,254,2579,2503,20497
Mitchell Butler,188,77,University of Memphis,1946,362,5464,707,1613,359,576,95,313,612,1300,246,471,717,342,214,53,353,576,1868
Mitchell Wiggins,193,83,Florida State University,1959,307,5982,1197,2578,458,602,7,44,1190,2534,447,460,907,422,291,23,314,664,2859
Mo Williams,203,102,University of Notre Dame,1971,944,27640,4683,10916,1877,2159,1292,3483,3391,7433,450,2141,2591,4794,820,145,2192,2317,12535
Monta Ellis,190,83,NaN,1985,891,31131,6173,13728,2894,3738,799,2550,5374,11178,540,2534,3074,4202,1495,299,2423,2086,16039
Montrezl Harrell,203,108,University of Louisville,1994,97,1443,283,435,100,167,1,8,282,427,106,178,284,81,31,53,61,174,667
Monty Williams,203,102,University of Notre Dame,1971,487,7808,1170,2443,608,913,4,37,1166,2406,521,815,1336,552,257,139,572,923,2952
Moochie Norris,185,79,University of West Florida,1973,594,9271,977,2471,627,845,140,490,837,1981,241,792,1033,1443,403,27,648,628,2721
Mookie Blaylock,183,81,University of Oklahoma,1967,889,31026,4705,11499,1269,1724,1283,3816,3422,7683,1017,2642,3659,5972,2075,300,2067,1687,11962
Morlon Wiley,193,83,"California State University, Long Beach",1966,465,6290,659,1616,154,221,231,652,428,964,148,418,566,1181,392,25,491,725,1703
Morris Almond,198,102,Rice University,1985,38,361,43,113,26,35,7,24,36,89,10,36,46,12,12,4,19,42,119
Morris Peterson,201,98,Michigan State University,1977,711,19366,2747,6567,1125,1456,1009,2702,1738,3865,569,1914,2483,1090,639,136,716,1606,7628
Moses Malone*,208,97,NaN,1955,714,21750,4202,8940,4362,5467,7,60,4195,8880,2925,4183,7108,902,496,708,1842,1364,12773
Mouhamed Sene,201,99,NaN,1984,53,289,41,91,41,66,0,0,41,91,33,56,89,1,5,25,19,46,123
Muggsy Bogues,160,61,Wake Forest University,1965,950,26999,2986,6533,1123,1352,110,397,2876,6136,564,1886,2450,7057,1436,42,1538,1640,7205
Mustafa Shakur,190,86,University of Arizona,1984,25,170,21,62,9,17,1,11,20,51,7,15,22,29,5,3,20,17,52
Mychal Thompson,208,102,University of Minnesota,1955,627,15926,2848,5749,1490,2166,2,10,2846,5739,1270,2441,3711,789,396,515,1031,1681,7188
Mychel Thompson,208,102,University of Minnesota,1955,5,95,7,24,0,0,4,11,3,13,0,5,5,7,2,1,5,8,18
Myles Turner,211,110,University of Texas at Austin,1996,141,3908,708,1399,333,424,43,129,665,1270,207,712,919,147,99,259,172,420,1792
Myron Brown,190,81,Slippery Rock University of Pennsylvania,1969,4,23,4,6,0,0,1,3,3,3,0,3,3,6,1,0,4,2,9
Myron Jackson,190,83,University of Arkansas at Little Rock,1964,8,22,2,9,7,8,0,0,2,9,1,2,3,6,1,0,5,1,11
Nando De,206,97,NaN,1968,166,1908,233,547,97,114,67,188,166,359,51,233,284,268,85,18,151,183,630
Nate Blackwell,193,77,Temple University,1965,10,112,15,41,5,6,2,11,13,30,2,4,6,18,3,0,8,16,37
Nate Driggers,196,97,University of Montevallo,1973,15,132,13,43,10,14,0,9,13,34,12,10,22,6,3,2,6,10,36
Nate Huffman,216,111,Central Michigan University,1975,7,76,9,25,5,8,0,0,9,25,9,14,23,5,1,3,3,13,23
Nate Johnston,203,95,University of Tampa,1966,42,174,36,96,18,26,2,8,34,88,26,20,46,2,6,16,12,22,92
Nate McMillan,196,88,North Carolina State University,1964,796,20462,1833,4136,769,1183,298,870,1535,3266,919,2303,3222,4893,1544,356,1486,2408,4733
Nate Robinson,175,81,University of Washington,1984,775,16597,2911,6935,1197,1514,994,2790,1917,4145,445,1251,1696,2197,641,54,1047,1789,8013
Nate Wolters,193,86,South Dakota State University,1991,100,1803,210,503,63,102,18,76,192,427,49,168,217,229,51,19,83,103,501
Nathan Jawai,208,127,Midland College,1986,45,431,50,115,26,38,0,1,50,114,50,56,106,24,10,9,29,61,126
Nazr Mohammed,208,100,University of Kentucky,1977,1377,23277,3619,7358,1527,2396,0,12,3619,7346,2682,4255,6937,559,649,928,1358,3114,8765
Ndudi Ebi,206,90,NaN,1984,19,86,17,35,6,13,0,1,17,34,8,11,19,4,1,5,6,13,40
Negele Knight,185,79,University of Dayton,1967,388,6659,981,2228,491,654,40,144,941,2084,163,352,515,1104,178,46,500,594,2493
Nemanja Bjelica,208,108,NaN,1988,125,2265,261,591,85,116,104,302,157,289,106,348,454,162,66,41,106,308,711
Nemanja Nedovic,190,87,NaN,1991,24,142,8,39,7,8,3,18,5,21,3,12,15,13,0,1,13,13,26
Nenad Krstic,213,108,NaN,1983,490,12118,1955,3945,873,1187,2,14,1953,3931,896,1700,2596,373,188,311,553,1435,4785
Nene Hilario,211,113,NaN,1982,910,25043,4190,7659,2566,3878,7,52,4183,7607,1663,4156,5819,1728,1037,731,1735,2819,10953
Nerlens Noel,211,103,University of Kentucky,1994,244,6370,976,1858,428,679,1,4,975,1854,525,1216,1741,350,381,344,406,652,2381
Nick Anderson,198,92,University of Illinois at Urbana-Champaign,1968,800,24922,4416,9891,1642,2461,1055,2964,3361,6927,1011,3053,4064,2087,1114,364,1358,1502,11529
Nick Calathes,198,96,University of Florida,1989,129,2011,246,558,68,117,30,104,216,454,42,201,243,353,129,13,162,217,590
Nick Collison,208,115,University of Kansas,1980,895,18528,2199,4127,909,1252,21,101,2178,4026,1759,2921,4680,935,446,469,871,2500,5328
Nick Fazekas,211,106,"University of Nevada, Reno",1985,52,538,92,164,30,44,0,4,92,160,68,110,178,22,16,22,26,50,214
Nick Johnson,190,91,University of Arizona,1992,28,262,26,75,17,25,5,21,21,54,13,26,39,11,7,3,19,34,74
Nick Van,211,113,NaN,1970,952,31465,5137,12684,2059,2592,1647,4628,3490,8056,403,2396,2799,6255,770,103,2006,1484,13980
Nick Vanos,216,115,Santa Clara University,1963,68,842,88,230,46,82,0,2,88,228,88,152,240,59,21,28,68,128,222
Nick Young,201,95,University of Southern California,1985,698,16718,3006,7207,1455,1740,1016,2712,1990,4495,271,1162,1433,705,400,144,753,1353,8483
Nicolas Batum,203,90,NaN,1988,628,19893,2694,6177,1187,1413,1025,2875,1669,3302,682,2659,3341,2304,594,426,1179,1145,7600
Nicolas Brussino,201,88,NaN,1993,54,521,52,141,17,22,29,95,23,46,26,69,95,47,17,8,26,43,150
Nicolas Laprovittola,193,81,NaN,1990,18,174,20,47,9,9,10,27,10,20,1,9,10,28,4,1,19,19,59
Nik Stauskas,198,92,University of Michigan,1993,226,5124,569,1475,268,332,286,833,283,642,55,442,497,393,109,69,262,351,1692
Nikita Wilson,203,90,Louisiana State University,1964,15,54,7,23,5,6,0,0,7,23,2,9,11,3,0,0,5,7,19
Nikola Jokic,208,113,NaN,1995,153,3771,801,1454,342,418,73,223,728,1231,393,885,1278,548,140,106,275,422,2017
Nikola Mirotic,208,99,NaN,1991,218,4979,759,1858,473,593,363,1036,396,822,182,968,1150,272,165,156,270,451,2354
Nikola Pekovic,211,139,NaN,1986,271,6744,1314,2537,777,1023,0,0,1314,2537,803,1004,1807,199,140,151,414,632,3405
Nikola Vucevic,213,117,University of Southern California,1990,399,11912,2592,5159,593,825,30,101,2562,5058,1134,2820,3954,812,325,358,674,1071,5807
Nikoloz Tskitishvili,213,102,NaN,1983,224,2265,225,737,97,136,46,203,179,534,130,240,370,127,55,63,151,268,593
Noah Vonleh,208,108,Indiana University,1995,177,2698,277,624,116,171,23,79,254,545,250,528,778,65,61,62,125,326,693
Noel Felix,206,102,"California State University, Fresno",1981,12,82,6,25,5,8,1,3,5,22,3,10,13,2,2,3,8,13,18
Nolan Smith,188,83,Duke University,1988,84,829,109,294,40,56,19,73,90,221,24,59,83,97,25,4,71,81,277
Norm Nixon,188,77,Duquesne University,1955,201,6350,1152,2572,349,445,83,249,1069,2323,113,363,476,1626,225,7,581,387,2736
Norm Richardson,196,86,Hofstra University,1979,22,134,20,52,12,18,8,16,12,36,6,10,16,4,0,0,6,10,60
Norman Powell,193,97,"University of California, Los Angeles",1993,125,2093,324,735,169,212,92,262,232,473,42,237,279,129,80,24,102,186,909
Norris Cole,188,79,Cleveland State University,1988,435,9849,1235,3027,347,470,262,815,973,2212,92,769,861,1236,337,49,616,803,3079
Norris Coleman,203,95,Kansas State University,1961,29,431,66,191,20,36,1,2,65,189,36,45,81,13,11,6,16,51,153
O.J. Mayo,201,99,NaN,1984,547,16919,2808,6547,1104,1346,854,2287,1954,4260,285,1421,1706,1607,559,141,1130,1239,7574
Obinna Ekezie,206,122,University of Maryland,1975,176,1797,197,471,217,303,0,1,197,470,177,284,461,40,43,32,109,302,611
Ognjen Kuzmic,216,113,NaN,1990,37,164,13,25,9,15,0,0,13,25,17,21,38,8,5,5,15,30,35
Okaro White,203,92,Florida State University,1992,35,471,33,87,20,22,12,34,21,53,25,57,82,21,10,10,18,52,98
Olden Polynice,211,99,University of Virginia,1964,1205,29378,4219,8263,1389,2584,5,29,4214,8234,3249,5223,8472,827,601,750,1336,3216,9832
Oleksiy Pecherov,213,105,NaN,1985,111,1044,160,414,73,92,45,155,115,259,88,178,266,20,21,22,59,119,438
Oliver Lafayette,188,86,University of Houston,1984,1,22,3,6,0,0,1,2,2,4,1,3,4,2,0,0,1,0,7
Oliver Miller,206,127,University of Arkansas,1970,554,12490,1659,3112,596,937,5,45,1654,3067,1045,2154,3199,1148,502,821,1011,1641,3919
Olumide Oyedeji,208,108,NaN,1981,93,587,50,101,27,41,0,0,50,101,61,135,196,11,16,15,30,106,127
Omar Cook,185,86,St. John's University,1982,22,213,17,51,3,6,0,5,17,46,5,8,13,46,16,1,16,20,37
Omer Asik,213,115,NaN,1986,453,9034,938,1773,581,1049,0,1,938,1772,1027,2288,3315,277,165,335,533,908,2457
Omri Casspi,206,102,NaN,1988,535,11342,1589,3579,641,954,483,1317,1106,2262,453,1699,2152,622,347,109,564,861,4302
Orien Greene,193,94,University of Louisiana at Lafayette,1982,131,1555,127,328,61,95,11,52,116,276,49,146,195,155,98,15,144,228,326
Orlando Graham,203,99,Auburn University at Montgomery,1965,7,22,3,10,2,4,0,0,3,10,8,3,11,0,0,0,2,6,8
Orlando Johnson,196,99,"University of California, Santa Barbara",1989,155,1605,162,474,73,100,58,208,104,266,46,204,250,91,29,19,67,121,455
Orlando Woolridge,206,97,University of Notre Dame,1959,702,20237,4306,8534,2771,3708,7,89,4299,8445,1114,1873,2987,1410,448,468,1374,1706,11390
Oscar Torres,198,95,NaN,1976,82,1184,151,377,96,125,44,139,107,238,50,84,134,43,29,11,57,73,442
Othell Wilson,183,86,University of Virginia,1961,127,2049,216,476,97,130,6,34,210,442,63,149,212,424,119,16,172,189,535
Othella Harrington,206,106,Georgetown University,1974,783,15739,2268,4508,1341,1809,0,14,2268,4494,1226,2292,3518,499,219,331,1093,2105,5877
Othello Hunter,203,102,Ohio State University,1986,23,125,15,32,3,9,0,0,15,32,15,21,36,1,2,6,5,16,33
Othyus Jeffers,196,90,Robert Morris University (IL),1985,60,811,80,171,79,119,2,12,78,159,60,111,171,43,38,0,36,80,241
Otis Birdsong,190,86,University of Houston,1955,220,6354,1411,2838,336,572,22,72,1389,2766,228,309,537,741,229,36,446,542,3180
Otis Smith,196,95,Jacksonville University,1964,447,9269,1865,4046,1002,1311,60,228,1805,3818,730,933,1663,845,468,230,666,964,4792
Otis Thorpe,206,102,Providence College,1962,1401,44115,7551,13898,4184,6133,3,76,7548,13822,3799,7666,11465,3064,929,559,3058,4608,19289
Otto Porter,203,89,Georgetown University,1993,266,6632,962,2002,260,336,285,733,677,1269,306,878,1184,316,273,104,179,479,2469
Ozell Jones,211,106,"California State University, Fullerton",1960,70,906,106,182,33,83,0,1,106,181,65,175,240,56,32,58,64,144,245
P.J. Brown,229,106,NaN,1972,1089,33823,3852,8365,2158,2718,8,59,3844,8306,3002,5407,8409,1661,912,1116,1342,3218,9870
P.J. Hairston,206,102,NaN,1990,177,3313,377,1085,131,164,189,645,188,440,72,368,440,97,85,35,104,335,1074
P.J. Tucker,206,97,NaN,1986,499,13878,1384,3223,582,772,391,1111,993,2112,817,2043,2860,750,619,123,514,1134,3741
Pablo Prigioni,190,83,NaN,1977,337,5763,425,1014,110,127,260,701,165,313,175,449,624,936,347,7,319,517,1220
Pace Mannion,201,86,University of Utah,1960,169,1688,211,505,112,173,13,68,198,437,65,140,205,186,85,19,112,180,547
Pape Sow,208,113,"California State University, Fullerton",1981,76,879,79,190,61,90,0,0,79,190,78,136,214,12,34,24,41,166,219
Pape Sy,201,102,NaN,1988,3,21,2,6,3,3,0,1,2,5,2,1,3,2,1,0,3,1,7
Pascal Siakam,206,104,New Mexico State University,1994,55,859,103,205,22,32,1,7,102,198,64,121,185,17,26,45,33,109,229
Pat Burke,211,113,Auburn University,1973,127,1293,199,488,61,92,9,36,190,452,90,176,266,44,28,40,87,180,468
Pat Connaughton,196,93,University of Notre Dame,1993,73,459,50,121,12,14,22,54,28,67,21,63,84,38,8,2,27,29,134
Pat Cummings,206,104,University of Cincinnati,1956,299,6591,1195,2453,512,700,0,9,1195,2444,551,1173,1724,291,164,68,548,899,2902
Pat Durham,201,95,Colorado State University,1967,64,930,123,262,72,108,5,26,118,236,42,66,108,57,37,33,52,120,323
Pat Garrity,206,107,University of Notre Dame,1976,552,11062,1479,3543,428,531,631,1587,848,1956,343,1114,1457,443,246,104,417,1274,4017
Patricio Garino,198,95,George Washington University,1993,5,43,0,7,0,0,0,5,0,2,1,6,7,0,0,0,3,4,0
Patrick Beverley,185,83,University of Arkansas,1988,291,8290,968,2339,295,386,477,1272,491,1067,352,834,1186,980,366,118,384,895,2708
Patrick Christopher,196,94,University of California,1988,4,29,3,12,0,0,0,4,3,8,2,4,6,0,1,0,1,6,6
Patrick Eddie,211,108,University of Mississippi,1967,4,13,2,9,0,0,0,0,2,9,0,1,1,0,0,0,0,3,4
Patrick Ewing,213,108,Georgetown University,1962,7,19,0,5,3,4,0,2,0,3,1,1,2,2,0,1,1,1,3
Patrick Ewing*,213,108,Georgetown University,1962,1183,40594,9702,19241,5392,7289,19,125,9683,19116,2752,8855,11607,2215,1136,2894,3537,4034,24815
Patrick McCaw,201,83,"University of Nevada, Las Vegas",1995,71,1074,106,245,29,37,41,123,65,122,22,79,101,77,32,15,36,62,282
Patrick O'Bryant,213,117,Bradley University,1986,129,779,124,244,39,68,0,5,124,239,45,148,193,36,24,59,64,187,287
Patrick Patterson,206,104,University of Kentucky,1989,613,14742,2060,4414,401,541,517,1400,1543,3014,924,1986,2910,737,369,326,489,1181,5038
Patty Mills,203,111,Louisiana Tech University,1985,441,7482,1291,2959,290,348,592,1499,699,1460,139,536,675,957,283,26,406,521,3464
Pau Gasol,213,113,NaN,1980,1185,41180,8126,15898,4861,6424,134,369,7992,15529,3089,8013,11102,3846,607,1945,2638,2621,21247
Paul Davis,211,122,Michigan State University,1984,82,702,88,219,41,56,0,1,88,218,74,84,158,32,22,15,30,105,217
Paul George,206,99,"California State University, Fresno",1990,448,14692,2775,6419,1643,1934,897,2425,1878,3994,386,2430,2816,1419,738,194,1139,1190,8090
Paul Graham,198,90,Ohio University,1967,179,3354,582,1299,235,318,100,295,482,1004,137,296,433,352,186,32,216,389,1499
Paul Grant,213,111,University of Wisconsin,1974,22,124,15,35,3,8,0,0,15,35,9,10,19,3,3,1,11,25,33
Paul McPherson,193,95,DePaul University,1978,110,1190,218,432,84,116,4,24,214,408,80,78,158,76,50,8,94,160,524
Paul Millsap,203,111,Louisiana Tech University,1985,837,24683,4484,9104,2589,3517,333,1014,4151,8090,1910,4344,6254,1922,1100,868,1521,2638,11890
Paul Mokeski,213,113,University of Kansas,1957,394,4977,559,1280,280,388,10,43,549,1237,368,893,1261,235,124,115,249,965,1408
Paul Pierce,201,106,University of Kansas,1977,1343,45880,8668,19465,6918,8578,2143,5816,6525,13649,1092,6435,7527,4708,1752,745,3532,3643,26397
Paul Pressey,196,83,University of Tulsa,1958,564,16401,2366,4896,1650,2127,76,338,2290,4558,716,1519,2235,3256,812,331,1381,1617,6458
Paul Shirley,208,104,Iowa State University,1977,18,121,15,38,3,7,0,1,15,37,9,10,19,7,1,1,10,12,33
Paul Thompson,198,95,Tulane University,1961,121,2316,448,1112,175,217,14,72,434,1040,141,238,379,180,127,67,144,287,1085
Paul Zipser,203,97,NaN,1994,44,843,88,221,31,40,33,99,55,122,15,110,125,36,15,16,40,78,240
Pavel Podkolzin,226,117,NaN,1985,6,28,0,2,4,8,0,0,0,2,0,9,9,0,0,1,4,4,4
Pearl Washington,188,86,Syracuse University,1964,194,4044,666,1472,312,418,16,87,650,1385,140,230,370,733,256,15,438,448,1660
Peja Stojakovic,206,99,NaN,1977,908,30184,5370,11964,2498,2785,1979,4932,3391,7032,840,3432,4272,1573,805,118,1210,1593,15217
Pepe Sanchez,193,88,Temple University,1977,67,337,18,61,4,4,0,2,18,59,10,26,36,90,27,2,14,45,40
Pero Antic,211,117,NaN,1982,113,1962,231,590,138,189,108,344,123,246,115,283,398,107,37,26,104,258,708
Perry Jones,211,106,Baylor University,1991,143,1675,195,464,62,94,36,123,159,341,46,206,252,54,36,33,60,135,488
Perry Moss,188,83,Northeastern University,1958,208,2722,323,791,179,247,15,78,308,713,97,228,325,306,154,33,215,360,840
Perry Young,196,95,Virginia Polytechnic Institute and State Unive...,1963,18,144,12,42,2,4,0,0,12,42,6,10,16,14,10,2,8,28,26
Pervis Ellison,206,95,University of Louisville,1967,474,11593,1826,3579,841,1221,1,20,1825,3559,1087,2083,3170,691,293,752,798,1493,4494
Pete Chilcutt,208,104,University of North Carolina,1968,716,10360,1300,2943,267,386,197,535,1103,2408,838,1599,2437,601,335,259,484,1090,3064
Pete Myers,198,81,University of Arkansas at Little Rock,1963,533,8152,871,2113,631,947,46,213,825,1900,303,637,940,1135,352,106,645,966,2419
Pete Verhoeven,206,97,"California State University, Fresno",1959,120,1159,146,289,46,68,1,2,145,287,95,135,230,48,46,25,50,237,339
Pete Williams,201,86,University of Arizona,1965,58,583,68,113,17,40,0,0,68,113,47,100,147,15,19,23,20,69,153
Peter Aluma,208,117,Liberty University,1973,2,5,1,2,0,0,0,0,1,2,1,1,2,0,1,1,2,4,2
Peter John,226,117,NaN,1985,6,20,5,10,1,2,0,0,5,10,1,3,4,0,0,1,3,4,11
Peter Thibeaux,201,95,Saint Mary's College of California,1961,93,992,194,428,72,115,2,7,192,421,57,87,144,45,34,32,73,167,462
Petur Gudmundsson,218,117,University of Washington,1958,82,1215,168,342,138,176,0,1,168,341,115,262,377,94,22,66,122,237,474
Peyton Siva,183,83,University of Louisville,1990,24,224,18,57,11,15,7,25,11,32,2,12,14,34,9,1,18,27,54
Phil Ford,188,79,University of North Carolina,1956,25,290,14,47,16,18,0,4,14,43,3,24,27,61,6,1,17,33,44
Phil Hubbard,203,97,University of Michigan,1956,276,6794,1094,2173,808,1146,0,14,1094,2159,571,737,1308,371,223,26,527,747,2996
Phil Pressey,180,79,University of Missouri,1991,171,2298,202,583,88,144,52,207,150,376,39,208,247,508,134,19,194,207,544
Phil Zevenbergen,208,104,University of Washington,1964,8,58,15,27,0,2,0,0,15,27,4,9,13,3,3,1,4,12,30
Pierre Jackson,178,81,Baylor University,1991,8,84,13,39,6,7,3,11,10,28,1,8,9,19,2,0,3,5,35
Pooh Richardson,185,81,"University of California, Los Angeles",1966,639,19399,3046,6867,633,971,358,1087,2688,5780,435,1372,1807,4180,817,111,1165,1129,7083
Popeye Jones,203,113,Murray State University,1970,535,12579,1574,3523,553,736,25,89,1549,3434,1623,2358,3981,696,300,161,603,1501,3726
Pops Mensah-Bonsu,206,108,George Washington University,1983,103,912,116,292,99,162,0,4,116,288,154,174,328,20,27,28,69,145,331
Predrag Drobnjak,211,122,NaN,1975,278,5542,903,2125,315,394,66,194,837,1931,313,660,973,225,132,117,242,512,2187
Predrag Savovic,198,102,University of Hawaii,1976,27,256,29,93,21,29,4,26,25,67,9,16,25,22,14,1,21,33,83
Priest Lauderdale,224,147,Central State University,1973,74,525,102,216,51,92,0,1,102,215,43,100,143,33,8,26,83,102,255
Primoz Brezec,218,114,NaN,1979,413,6762,1065,2154,452,655,1,6,1064,2148,605,828,1433,191,73,144,300,832,2583
Purvis Short,201,95,Jackson State University,1957,404,11777,2796,6010,1470,1745,90,305,2706,5705,575,938,1513,971,421,103,800,1102,7152
Quentin Richardson,198,101,DePaul University,1980,783,20785,2923,7360,1019,1420,1167,3288,1756,4072,933,2733,3666,1138,607,148,868,1529,8032
Quincy Acy,201,108,Baylor University,1990,358,5315,585,1242,317,429,120,321,465,921,358,870,1228,198,143,143,206,681,1607
Quincy Douby,190,79,Rutgers University,1984,170,1835,264,681,93,105,82,264,182,417,40,144,184,118,55,26,100,155,703
Quincy Lewis,201,97,University of Minnesota,1977,159,1853,232,584,66,93,37,111,195,473,71,139,210,96,59,36,98,335,567
Quincy Miller,206,95,Baylor University,1992,79,1053,116,344,56,79,36,131,80,213,45,144,189,45,37,42,59,91,324
Quincy Pondexter,201,99,University of Washington,1988,354,6835,716,1691,279,380,293,797,423,894,237,525,762,324,122,70,205,566,2004
Quinn Buckner,190,86,Indiana University,1954,107,1277,123,297,51,77,0,2,123,295,35,103,138,234,103,5,122,222,297
Quinn Cook,188,83,Duke University,1993,28,376,66,132,4,10,22,52,44,80,2,12,14,52,8,0,26,26,158
Quintin Dailey,190,81,University of San Francisco,1961,370,7640,1883,4223,1050,1347,12,76,1871,4147,273,539,812,654,319,30,600,765,4828
Quinton Ross,198,88,Southern Methodist University,1981,510,9020,804,1935,294,416,53,175,751,1760,284,712,996,443,276,135,228,923,1955
Qyntel Woods,203,100,Northeast Mississippi Community College,1981,167,2060,281,621,94,156,35,98,246,523,107,278,385,105,71,28,138,226,691
R.J. Hunter,201,104,NaN,1991,39,324,36,99,6,7,19,64,17,35,2,36,38,13,14,4,11,29,97
Radisav Curcic,208,124,NaN,1965,20,166,16,41,26,36,0,0,16,41,17,32,49,12,7,2,8,30,58
Raef LaFrentz,211,108,University of Kansas,1976,641,17000,2648,5701,863,1217,582,1583,2066,4118,1170,2832,4002,695,331,1132,605,2144,6741
Rafael Addison,201,97,Syracuse University,1964,379,5697,920,2047,277,359,69,245,851,1802,262,518,780,339,148,83,284,671,2186
Rafael Araujo,211,127,Brigham Young University,1980,139,1585,156,385,76,112,1,4,155,381,124,271,395,41,51,16,111,300,389
Rafer Alston,188,77,"California State University, Fresno",1976,800,23260,2921,7657,1118,1527,1166,3314,1755,4343,293,1954,2247,3784,971,125,1430,1646,8126
Raja Bell,196,92,Florida International University,1976,779,22308,2908,6694,970,1206,1082,2655,1826,4039,454,1780,2234,1363,538,140,786,2021,7868
Rajon Rondo,185,84,University of Kentucky,1986,782,25063,3455,7516,1037,1738,267,876,3188,6640,862,2994,3856,6613,1375,103,2279,1764,8214
Rakeem Christmas,206,113,Syracuse University,1991,30,225,21,45,21,29,0,0,21,45,27,30,57,4,3,6,8,38,63
Ralph Jackson,188,86,"University of California, Los Angeles",1962,1,12,1,3,0,0,0,0,1,3,1,0,1,4,2,0,1,1,2
Ralph Lewis,198,90,La Salle University,1963,106,698,93,222,52,91,1,4,92,218,60,64,124,29,26,7,47,70,239
Ralph Sampson*,224,103,University of Virginia,1960,422,12561,2507,5325,1043,1548,11,65,2496,5260,1021,2539,3560,997,361,643,1240,1415,6068
Ramon Rivas,208,117,Temple University,1966,28,91,12,31,16,25,0,1,12,30,9,15,24,3,4,1,9,21,40
Ramon Sessions,190,86,"University of Nevada, Reno",1986,874,20836,3061,7090,2730,3449,297,913,2764,6177,427,1936,2363,3606,579,62,1518,1176,9149
Randell Jackson,188,86,"University of California, Los Angeles",1962,28,272,46,108,21,32,1,7,45,101,30,24,54,8,3,11,26,29,114
Randolph Childress,188,85,Wake Forest University,1972,74,560,53,159,34,43,23,85,30,74,3,28,31,66,26,1,64,54,163
Randolph Keys,201,88,University of Southern Mississippi,1966,321,4933,815,1907,279,387,54,190,761,1717,310,494,804,280,203,53,259,747,1963
Randolph Morris,208,120,University of Kentucky,1986,74,438,52,122,36,66,0,0,52,122,27,77,104,7,13,7,30,100,140
Randy Allen,203,99,Florida State University,1965,70,789,114,258,24,45,0,8,114,250,52,93,145,23,17,20,30,109,252
Randy Breuer,221,104,University of Minnesota,1960,705,13906,2128,4579,897,1425,0,5,2128,4574,1167,2127,3294,696,336,820,737,1562,5153
Randy Brown,203,99,University of Idaho,1965,655,11533,1275,3055,574,831,24,120,1251,2935,326,847,1173,1420,722,156,725,1263,3148
Randy Foye,193,96,Villanova University,1983,833,20921,2873,7232,1278,1503,1179,3267,1694,3965,269,1573,1842,2273,567,249,1192,1715,8203
Randy Holcomb,206,102,San Diego State University,1979,4,11,1,1,0,0,0,0,1,1,1,0,1,0,0,0,0,2,2
Randy Livingston,193,94,Louisiana State University,1975,203,2684,304,749,131,170,34,97,270,652,74,208,282,415,121,31,223,297,773
Randy White,203,108,Louisiana Tech University,1967,281,5382,783,1951,490,693,27,140,756,1811,531,835,1366,175,209,127,372,861,2083
Randy Wittman,198,95,Indiana University,1959,529,11643,1793,3604,371,488,18,54,1775,3550,199,570,769,1241,263,67,441,520,3975
Randy Woods,178,83,La Salle University,1970,151,1093,115,338,69,101,57,187,58,151,32,61,93,257,85,4,110,166,356
Rashad McCants,193,93,University of North Carolina,1984,307,6138,1115,2632,448,601,355,982,760,1650,135,481,616,399,230,75,426,687,3033
Rashad Vaughn,198,91,"University of Nevada, Las Vegas",1996,111,1459,138,422,14,20,69,228,69,194,15,122,137,62,48,26,42,105,359
Rashard Lewis,198,90,La Salle University,1963,1106,35365,5896,13061,2581,3207,1874,4869,4022,8192,1489,4234,5723,1857,1167,571,1664,2589,16247
Rasheed Wallace,208,102,University of North Carolina,1974,1177,38633,6745,14503,2436,3374,1168,3476,5577,11027,1680,6183,7863,2150,1151,1582,1812,3449,17094
Rasho Nesterovic,213,112,NaN,1976,811,17983,2570,5121,378,646,1,13,2569,5108,1513,2630,4143,836,330,934,748,2187,5519
Rastko Cvetkovic,216,117,NaN,1970,14,48,5,16,0,4,0,1,5,15,4,7,11,3,2,1,3,11,10
Rasual Butler,201,97,La Salle University,1979,856,17989,2372,5923,613,823,957,2656,1415,3267,307,1704,2011,685,296,423,552,1169,6314
Ratko Varda,216,117,NaN,1979,1,6,2,3,1,1,0,0,2,3,0,1,1,0,0,0,1,3,5
Raul Lopez,185,77,NaN,1980,113,2135,280,652,128,150,45,130,235,522,31,163,194,428,84,5,221,278,733
Raul Neto,185,81,NaN,1992,121,1845,221,509,60,79,74,193,147,316,21,129,150,208,83,7,124,170,576
Rawle Marshall,206,86,Oakland University,1982,63,602,56,149,53,74,5,21,51,128,16,44,60,23,20,12,34,39,170
Ray Allen,203,99,Florida State University,1965,1376,49224,9165,20318,4714,5265,3174,7962,5991,12356,1324,4329,5653,4695,1554,258,2907,3078,26218
Ray McCallum,190,86,University of Detroit Mercy,1991,195,3283,429,1062,113,157,86,254,343,808,86,267,353,428,91,34,172,219,1057
Ray Owes,206,101,University of Arizona,1972,57,592,75,180,26,46,1,5,74,175,64,99,163,15,15,20,23,86,177
Ray Tolbert,206,102,Indiana University,1958,100,859,110,232,61,97,0,0,110,232,77,121,198,36,29,23,77,133,281
Ray Williams,190,85,University of Minnesota,1954,149,2913,420,1045,310,358,25,89,395,956,112,192,304,649,190,22,338,415,1175
Raymond Brown,203,99,University of Idaho,1965,16,56,8,28,0,2,0,0,8,28,10,5,15,4,0,0,6,11,16
Raymond Felton,185,92,University of North Carolina,1984,931,29822,4253,10277,1864,2359,940,2851,3313,7426,571,2374,2945,5466,1211,196,2139,1900,11310
Reece Gaines,198,92,University of Louisville,1981,92,792,65,198,23,37,11,40,54,158,10,57,67,57,22,4,33,57,164
Reggie Bullock,201,92,University of North Carolina,1991,183,1967,188,487,38,49,102,291,86,196,40,246,286,84,57,14,47,115,516
Reggie Evans,203,111,University of Iowa,1980,930,17864,1309,2797,1261,2383,1,12,1308,2785,2270,4331,6601,517,643,128,1040,2180,3880
Reggie Geary,188,84,University of Arizona,1973,101,931,78,227,33,67,20,61,58,166,23,59,82,110,50,14,57,131,209
Reggie Hanson,203,88,University of Kentucky,1968,8,26,3,6,0,0,0,0,3,6,3,3,6,1,2,1,3,8,6
Reggie Jackson,190,94,Boston College,1990,480,12155,2291,5313,1006,1177,448,1411,1843,3902,269,1283,1552,2210,357,57,966,907,6036
Reggie Jordan,193,88,New Mexico State University,1968,205,1792,198,446,142,246,2,6,196,440,191,179,370,202,99,34,112,216,540
Reggie King,198,102,University of Alabama,1957,60,860,63,149,41,59,0,0,63,149,44,78,122,53,28,11,42,74,167
Reggie Lewis,201,88,Northeastern University,1965,450,14676,3198,6550,1479,1794,27,135,3171,6415,577,1361,1938,1153,569,417,708,1268,7902
Reggie Miller*,201,83,"University of California, Los Angeles",1965,1389,47619,8241,17499,6237,7026,2560,6486,5681,11013,883,3299,4182,4141,1505,299,2409,2730,25279
Reggie Slater,201,97,University of Wyoming,1970,278,3632,523,1079,456,726,0,2,523,1077,345,447,792,148,94,60,254,517,1502
Reggie Smith,208,108,Texas Christian University,1970,66,384,39,99,21,52,0,1,39,98,55,65,120,5,16,7,16,63,99
Reggie Theus,201,86,"University of Nevada, Las Vegas",1957,555,18809,3840,8199,2443,2878,139,517,3701,7682,567,1197,1764,3771,597,133,1829,1523,10262
Reggie Williams,201,86,Georgetown University,1964,938,22588,4135,9430,1579,2013,644,2026,3491,7404,1056,2250,3306,1989,1043,479,1362,2549,10493
Renaldo Balkman,203,94,University of South Carolina,1984,229,3126,374,734,150,275,12,66,362,668,280,496,776,134,168,106,135,436,910
Renaldo Major,201,90,"California State University, Fresno",1982,1,27,2,10,1,2,0,0,2,10,0,2,2,0,2,0,1,4,5
Rex Chapman,193,83,University of Kentucky,1967,688,20109,3829,8890,1530,1921,813,2330,3016,6560,389,1314,1703,1887,607,137,1075,1279,10001
Rex Walters,193,86,University of Kansas,1970,417,5447,657,1497,284,347,215,606,442,891,99,383,482,710,162,35,359,520,1813
Rich Kelley,213,106,Stanford University,1953,114,1600,131,265,102,134,0,4,131,261,147,284,431,163,52,33,146,289,364
Rich King,218,117,University of Nebraska,1969,72,309,44,112,47,71,0,2,44,110,30,44,74,21,5,7,28,62,135
Rich Manning,211,114,University of Washington,1970,81,713,113,277,27,42,4,9,109,268,48,85,133,13,11,10,31,95,257
Richard Anderson,208,108,"University of California, Santa Barbara",1960,325,4698,634,1576,188,244,186,557,448,1019,301,742,1043,410,173,56,221,475,1642
Richard Coffey,198,96,University of Minnesota,1965,52,320,28,75,12,22,0,1,28,74,42,37,79,3,6,4,5,45,68
Richard Dumas,190,77,Northeastern State University,1970,102,2226,434,852,209,301,3,13,431,839,160,191,351,111,137,47,150,228,1080
Richard Hamilton,198,83,University of Connecticut,1978,921,29559,5969,13288,3240,3805,530,1530,5439,11758,794,2058,2852,3125,714,131,1977,2329,15708
Richard Jefferson,201,105,University of Arizona,1980,1224,35878,5341,11563,3617,4717,1153,3031,4188,8532,941,3980,4921,2485,822,365,1813,2747,15452
Richard Morton,190,86,"California State University, Fullerton",1966,2,11,3,4,0,0,0,0,3,4,0,0,0,1,0,0,1,2,6
Richard Petruska,208,117,"University of California, Los Angeles",1969,22,92,20,46,6,8,7,15,13,31,9,22,31,1,2,3,15,15,53
Richard Rellford,198,104,University of Michigan,1964,4,42,5,8,6,8,0,0,5,8,2,5,7,1,0,3,4,3,16
Richaun Holmes,208,111,Bowling Green State University,1993,108,1895,344,634,123,177,35,121,309,513,156,290,446,91,61,95,87,228,846
Richie Frahm,196,95,Gonzaga University,1977,173,1815,217,533,58,73,118,337,99,196,39,158,197,104,41,12,43,152,610
Rick Brunson,193,86,Temple University,1972,426,5399,476,1263,238,341,118,326,358,937,100,427,527,1024,242,26,428,449,1308
Rick Calloway,198,81,University of Kansas,1966,64,678,75,192,55,79,0,2,75,190,25,53,78,61,22,7,51,98,205
Rick Carlisle,196,95,University of Virginia,1959,188,1461,178,422,55,71,11,48,167,374,44,97,141,201,42,9,120,187,422
Rick Fox,201,104,University of North Carolina,1969,930,23723,3382,7519,1431,1858,771,2208,2611,5311,996,2521,3517,2649,967,355,1611,2739,8966
Rick Hughes,196,97,Loyola University of Chicago,1962,21,224,35,72,12,26,0,1,35,71,24,25,49,9,3,1,14,30,82
Rick Mahorn,208,108,Hampton University,1958,821,16695,1890,3878,1116,1498,5,32,1885,3846,1258,3263,4521,661,407,554,944,2323,4901
Rick Robey,211,104,University of Kentucky,1956,50,677,74,200,34,50,0,3,74,197,43,113,156,63,21,5,74,99,182
Rickey Brown,208,97,Mississippi State University,1958,69,814,78,192,39,68,0,0,78,192,76,147,223,25,19,22,51,117,195
Rickey Green,183,77,University of Michigan,1954,619,12933,1934,4154,925,1084,38,160,1896,3994,188,732,920,2886,610,24,846,740,4831
Rickie Winslow,203,102,University of Houston,1964,7,45,3,13,1,2,0,1,3,12,3,4,7,2,1,0,4,9,7
Ricky Berry,203,92,San Jose State University,1964,64,1406,255,567,131,166,65,160,190,407,57,140,197,80,37,22,82,197,706
Ricky Blanton,201,97,Louisiana State University,1966,2,13,3,7,0,0,0,0,3,7,2,1,3,1,2,0,1,1,6
Ricky Davis,198,88,University of Iowa,1979,893,27608,4777,10664,2306,2967,708,1996,4069,8668,708,2551,3259,3079,919,226,2008,1791,12568
Ricky Grace,185,81,University of Oklahoma,1967,3,8,2,3,0,2,0,0,2,3,0,1,1,1,0,0,0,3,4
Ricky Ledo,201,88,NaN,1992,45,521,70,209,36,48,23,62,47,147,32,42,74,40,13,2,54,44,199
Ricky Pierce,193,92,Rice University,1959,999,25537,5890,11920,3791,4292,383,1115,5507,10805,893,1545,2438,2000,821,152,1569,2295,15954
Ricky Rubio,193,87,NaN,1990,353,11217,1137,3028,1141,1374,238,756,899,2272,253,1245,1498,2991,747,45,976,920,3653
Ricky Sobers,190,89,"University of Nevada, Las Vegas",1953,149,2769,520,1169,242,287,21,71,499,1098,56,146,202,432,93,11,243,295,1303
Ricky Wilson,196,90,University of Louisville,1956,48,840,86,220,58,80,20,52,66,168,4,50,54,138,46,6,50,80,250
Rik Smits,224,113,Marist College,1966,867,23100,5301,10461,2266,2932,3,26,5298,10435,1531,3746,5277,1215,372,1111,1579,3011,12871
Rob Kurz,206,105,University of Notre Dame,1985,40,442,51,131,40,50,15,38,36,93,33,48,81,20,14,19,16,78,157
Rob Lock,206,102,University of Kentucky,1966,20,110,9,32,12,15,0,0,9,32,14,18,32,4,3,4,13,15,30
Rob Rose,196,81,George Mason University,1964,2,3,0,1,0,0,0,0,0,1,1,1,2,0,0,0,0,0,0
Robbie Hummel,203,97,Purdue University,1989,98,1397,146,349,39,45,48,140,98,209,66,200,266,50,32,11,28,143,379
Robert Archibald,211,113,University of Illinois at Urbana-Champaign,1980,76,584,24,86,35,80,0,0,24,86,48,73,121,29,28,9,27,109,83
Robert Churchwell,198,88,Georgetown University,1972,4,20,3,8,0,0,0,0,3,8,0,3,3,1,0,0,2,1,6
Robert Covington,206,97,Tennessee State University,1990,211,6012,871,2214,461,568,478,1351,393,863,224,952,1176,304,331,140,403,627,2681
Robert Hite,188,83,University of Miami,1984,12,136,19,60,8,12,5,23,14,37,4,12,16,8,3,2,6,8,51
Robert Horry,206,99,University of Alabama,1970,1161,28464,2977,7003,1340,1852,844,2483,2133,4520,1712,3794,5506,2453,1224,1090,1450,2833,8138
Robert Pack,188,81,University of Southern California,1969,606,13244,2011,4783,1525,1932,145,502,1866,4281,289,969,1258,3008,699,49,1537,1180,5692
Robert Parish*,213,104,Centenary College of Louisiana,1953,984,27663,5286,9648,2342,3186,0,3,5286,9645,2638,5828,8466,1210,644,1142,1743,2312,12914
Robert Reid,203,92,St. Mary's University,1955,530,12087,2177,5013,696,948,110,361,2067,4652,385,1216,1601,1120,371,119,541,1321,5160
Robert Sacre,213,122,Gonzaga University,1989,189,2745,318,729,151,225,0,1,318,728,212,381,593,126,56,110,102,336,787
Robert Smith,180,74,"University of Nevada, Las Vegas",1955,7,48,4,17,8,10,0,4,4,13,0,4,4,7,2,0,3,6,16
Robert Swift,213,111,NaN,1985,97,1500,172,340,72,118,0,0,172,340,122,254,376,20,26,86,71,224,416
Robert Traylor,203,128,University of Michigan,1977,438,6243,841,1774,399,691,4,24,837,1750,671,969,1640,312,280,306,400,1079,2085
Robert Werdann,211,113,St. John's University,1970,47,273,37,98,27,47,0,1,37,97,31,50,81,9,13,8,20,65,101
Robert Whaley,208,117,Walsh University,1982,23,212,23,57,3,6,0,0,23,57,16,27,43,17,7,8,14,41,49
Robin Lopez,213,115,Stanford University,1988,628,14353,2257,4291,969,1274,0,6,2257,4285,1581,1887,3468,429,164,796,650,1303,5483
Rod Foster,185,72,"University of California, Los Angeles",1960,127,2022,371,854,106,142,50,158,321,696,36,102,138,307,83,1,178,248,898
Rod Higgins,201,90,"California State University, Fresno",1960,649,13748,2016,4312,1390,1702,339,976,1677,3336,714,1584,2298,987,379,276,596,1352,5761
Rod Strickland,196,90,Jacksonville University,1940,1291,38342,6093,13466,3808,5308,217,774,5876,12692,1332,3306,4638,9002,1831,245,3224,2360,16211
Rodney Buford,196,85,Creighton University,1977,230,4182,630,1530,138,182,74,247,556,1283,117,481,598,179,115,31,140,332,1472
Rodney Carney,201,92,University of Memphis,1984,326,4936,721,1709,246,351,217,629,504,1080,177,459,636,143,171,105,173,453,1905
Rodney Hood,203,93,Duke University,1992,188,5198,835,2012,323,395,337,926,498,1086,63,523,586,392,141,39,235,453,2330
Rodney McCray,201,99,University of Louisville,1961,689,22795,3181,6325,1743,2280,56,215,3125,6110,1472,3165,4637,2574,532,439,1299,1529,8161
Rodney McGruder,193,92,Kansas State University,1991,78,1966,190,460,44,71,73,220,117,240,95,162,257,124,45,18,56,140,497
Rodney Monroe,190,83,North Carolina State University,1968,38,313,53,144,19,23,6,27,47,117,12,21,33,27,12,2,23,19,131
Rodney Rogers,201,106,Wake Forest University,1971,1001,25120,4136,9200,1731,2483,826,2389,3310,6811,1465,3010,4475,1920,975,500,1825,3076,10829
Rodney Stuckey,196,95,Eastern Washington University,1986,651,17890,2904,6870,2101,2551,276,921,2628,5949,419,1493,1912,2333,568,94,1181,1346,8185
Rodney White,203,95,University of South Alabama,1959,276,4031,738,1744,242,331,115,350,623,1394,137,437,574,281,150,76,322,373,1833
Rodrick Rhodes,198,102,University of Southern California,1973,85,1390,138,412,143,230,4,22,134,390,47,58,105,132,74,14,139,167,423
Rodrigue Beaubois,183,77,NaN,1988,182,2896,502,1143,153,189,129,397,373,746,47,291,338,374,124,52,204,312,1286
Roger Mason,196,90,University of Virginia,1980,544,9475,1228,3031,322,372,607,1588,621,1443,79,849,928,703,200,81,390,745,3385
Roger Powell,198,106,University of Illinois at Urbana-Champaign,1983,3,13,0,3,2,2,0,1,0,2,3,0,3,0,0,0,3,2,2
Roko Ukic,196,83,NaN,1984,85,987,137,354,53,71,14,74,123,280,27,51,78,165,31,2,66,83,341
Rolando Blackman,198,86,Kansas State University,1959,742,24734,5214,10752,2739,3194,224,637,4990,10115,718,1640,2358,2403,576,178,1429,1269,13391
Rolando Ferreira,216,108,University of Houston,1964,12,34,1,18,7,8,0,0,1,18,4,9,13,1,0,1,6,7,9
Ron Anderson,201,97,"California State University, Fresno",1958,762,17144,3281,6953,1183,1475,114,401,3167,6552,1002,1637,2639,1113,534,99,822,1160,7859
Ron Baker,193,99,Wichita State University,1993,52,857,82,217,28,43,23,86,59,131,12,86,98,107,34,8,56,74,215
Ron Brewer,193,81,University of Arkansas,1955,128,1792,296,684,114,126,10,38,286,646,46,102,148,114,46,24,64,134,716
Ron Cavenall,216,104,Texas Southern University,1959,58,669,30,89,24,44,0,0,30,89,53,115,168,19,12,44,47,125,84
Ron Crevier,213,106,Boston College,1958,6,8,0,6,0,4,0,0,0,6,2,0,2,0,0,0,0,4,0
Ron Grandison,198,97,University of New Orleans,1964,133,1183,106,266,99,140,8,38,98,228,93,125,218,71,43,8,63,139,319
Ron Harper,198,83,Miami University,1964,1044,32566,5627,12583,2917,4030,537,1862,5090,10721,1396,3119,4515,4098,1797,770,2351,2429,14708
Ron Mercer,201,95,University of Kentucky,1976,553,17511,3261,7667,1160,1443,93,350,3168,7317,497,1273,1770,1207,563,149,922,1140,7775
Ron Moore,213,117,West Virginia State University,1962,28,118,18,58,12,16,0,0,18,58,4,12,16,2,10,0,8,42,48
Ron Rowan,196,90,St. John's University,1962,7,16,4,9,3,4,1,1,3,8,1,0,1,1,4,0,3,1,12
Ronald Dupree,201,94,Louisiana State University,1981,162,1779,219,513,116,206,5,13,214,500,117,230,347,101,58,29,90,252,559
Ronald Murray,193,86,Shaw University,1979,694,15798,2560,6209,1263,1752,454,1509,2106,4700,276,1153,1429,1577,560,131,1060,1104,6837
Rondae Hollis-Jefferson,201,99,University of Arizona,1995,107,2376,298,680,227,305,19,81,279,599,135,471,606,197,121,60,142,238,842
Ronnie Brewer,193,81,University of Arkansas,1955,644,14294,1836,3811,843,1273,122,470,1714,3341,540,1228,1768,1042,762,142,463,662,4637
Ronnie Lester,188,79,University of Iowa,1959,59,500,60,134,36,50,0,4,60,130,4,32,36,134,24,6,74,52,156
Ronnie Murphy,196,102,Jacksonville University,1964,18,89,14,49,7,11,1,4,13,45,5,6,11,6,5,1,8,14,36
Ronnie Price,188,86,Utah Valley State College,1983,544,7293,738,1980,295,400,244,808,494,1172,176,482,658,960,424,56,476,922,2015
Ronny Turiaf,208,112,Gonzaga University,1983,490,8299,875,1640,510,804,0,8,875,1632,540,1287,1827,628,195,610,372,1155,2260
Rony Seikaly,211,104,Syracuse University,1965,734,23031,3897,8119,2937,4293,6,34,3891,8085,2288,4529,6817,937,481,915,2059,2505,10737
Rory Sparrow,188,79,Villanova University,1958,683,16397,2309,5111,569,716,90,341,2219,4770,290,904,1194,3050,574,82,1055,1311,5277
Rory White,203,95,University of South Alabama,1959,223,4412,764,1515,348,496,1,12,763,1503,266,304,570,187,156,47,255,435,1877
Roshown McLeod,203,100,Duke University,1975,148,3052,483,1159,181,217,7,67,476,1092,129,299,428,182,64,22,198,288,1154
Roy Hibbert,218,122,Georgetown University,1986,710,17071,2702,5788,1422,1877,6,24,2696,5764,1581,2748,4329,906,249,1192,1070,2167,6832
Roy Hinson,206,95,Rutgers University,1961,504,16277,3045,6127,1857,2466,0,14,3045,6113,1040,2430,3470,525,344,877,1069,1857,7947
Roy Marble,198,86,University of Iowa,1966,29,194,18,70,19,32,0,2,18,68,18,14,32,12,7,3,17,17,55
Roy Rogers,201,106,Wake Forest University,1971,152,2415,297,621,77,147,1,2,296,619,188,312,500,59,29,217,106,286,672
Roy Tarpley,211,104,University of Michigan,1964,280,7476,1457,3014,613,824,6,34,1451,2980,964,1839,2803,292,317,329,557,950,3533
Royal Ivey,190,90,University of Texas at Austin,1981,536,6488,657,1614,244,345,176,484,481,1130,153,438,591,528,249,40,266,796,1734
Royce White,203,95,University of South Alabama,1959,3,9,0,1,0,0,0,0,0,1,0,0,0,0,0,0,0,2,0
Ruben Boumtje-Boumtje,213,116,Georgetown University,1978,44,276,14,38,15,27,0,0,14,38,22,35,57,6,4,17,14,40,43
Ruben Garces,206,111,Providence College,1973,26,146,14,44,4,16,0,0,14,44,32,26,58,10,6,4,10,28,32
Ruben Nembhard,190,94,Weber State University,1972,20,226,32,74,16,20,0,12,32,62,6,10,16,34,18,0,16,24,80
Ruben Patterson,196,101,University of Cincinnati,1975,720,17747,3005,5815,1765,2774,36,209,2969,5606,1398,1543,2941,1277,827,270,1316,1568,7811
Ruben Wolkowyski,208,122,NaN,1973,41,329,27,83,26,38,0,3,27,80,12,35,47,4,6,18,13,41,80
Rudy Fernandez,198,83,NaN,1985,249,5965,740,1853,361,430,413,1147,327,706,128,480,608,554,249,40,286,369,2254
Rudy Gay,203,104,University of Connecticut,1986,901,32033,6303,14030,3136,3922,941,2753,5362,11277,1329,4021,5350,2120,1215,725,2238,2239,16683
Rudy Gobert,216,111,NaN,1992,269,7268,905,1479,674,1097,0,3,905,1476,838,1795,2633,304,166,579,405,641,2484
Rumeal Robinson,188,88,University of Michigan,1966,421,7002,1135,2661,445,729,138,402,997,2259,176,509,685,1315,343,59,666,707,2853
Russ Schoene,208,95,University of Tennessee at Chattanooga,1960,213,2326,414,993,126,166,61,181,353,812,188,292,480,116,96,48,147,381,1015
Russ Smith,183,74,University of Louisville,1991,39,196,23,72,32,39,5,27,18,45,3,18,21,27,11,1,31,31,83
Russell Westbrook,190,90,"University of California, Los Angeles",1988,668,22786,5239,12093,3972,4829,706,2258,4533,9835,1110,3039,4149,5293,1154,197,2620,1616,15156
Rusty LaRue,188,95,Wake Forest University,1973,98,1565,187,497,58,69,54,170,133,327,22,104,126,152,62,11,94,147,486
Ryan Anderson,208,108,University of California,1988,556,14708,2525,5977,1082,1257,1184,3107,1341,2870,1135,1886,3021,505,304,195,549,1111,7316
Ryan Bowen,201,97,University of Iowa,1975,507,6502,544,1192,217,313,14,68,530,1124,506,554,1060,250,325,138,168,752,1319
Ryan Gomes,201,113,Providence College,1982,487,13463,1891,4249,810,1014,334,956,1557,3293,617,1622,2239,712,351,78,550,942,4926
Ryan Hollins,213,108,"University of California, Los Angeles",1984,639,7560,832,1434,647,1019,0,1,832,1433,584,833,1417,177,112,341,467,1255,2311
Ryan Humphrey,203,106,University of Notre Dame,1979,133,1216,113,347,64,115,0,3,113,344,120,168,288,29,29,37,71,188,290
Ryan Kelly,211,104,Duke University,1991,163,3125,324,857,231,290,102,323,222,534,77,427,504,215,79,84,106,309,981
Ryan Lorthridge,193,86,Jackson State University,1972,37,672,106,223,57,88,3,14,103,209,24,47,71,101,28,1,57,42,272
Ryan Reid,203,105,Florida State University,1986,5,17,4,5,0,0,0,0,4,5,1,1,2,0,0,0,1,1,8
Ryan Robertson,196,86,University of Kansas,1976,1,25,2,6,1,1,0,2,2,4,0,0,0,0,0,0,0,0,5
Ryan Stack,211,97,University of South Carolina,1975,43,397,31,88,37,47,0,1,31,87,34,45,79,10,6,22,26,78,99
Salah Mejri,216,111,NaN,1986,107,1302,137,215,63,107,1,4,136,211,138,293,431,24,40,97,63,206,338
Salim Stoudamire,185,81,University of Arizona,1982,157,2672,446,1097,201,228,167,456,279,641,22,192,214,164,55,10,158,240,1260
Sam Bowie,216,106,University of Kentucky,1961,511,14098,2127,4702,1278,1708,32,106,2095,4596,1192,2653,3845,1075,263,909,978,1553,5564
Sam Cassell,190,83,Florida State University,1969,1117,32999,6307,13966,3953,4589,778,2346,5529,11620,687,2867,3554,6494,1181,188,2703,3064,17345
Sam Dekker,206,104,University of Wisconsin,1994,80,1425,203,429,38,68,60,187,143,242,94,191,285,76,39,21,41,83,504
Sam Jacobson,193,97,University of Minnesota,1975,120,1433,228,447,64,87,18,49,210,398,53,98,151,68,63,6,67,247,538
Sam Mack,201,99,University of Houston,1970,303,6111,880,2165,307,366,416,1098,464,1067,123,505,628,391,199,41,253,553,2483
Sam Mitchell,198,95,Mercer University,1963,994,22257,3220,7206,2131,2719,65,292,3155,6914,1251,2460,3711,1089,548,301,838,2509,8636
Sam Perkins,206,106,University of North Carolina,1961,1365,38949,5879,12783,3729,4597,873,2419,5006,10364,2487,5703,8190,2131,1165,1015,1694,3402,16360
Sam Vincent,188,83,Michigan State University,1963,468,9028,1373,3052,909,1052,24,109,1349,2943,193,778,971,1924,323,76,791,743,3679
Sam Williams,190,81,University of Iowa,1945,46,488,58,148,28,47,0,1,58,147,38,68,106,11,26,26,44,92,144
Sam Young,198,99,University of Pittsburgh,1985,284,4341,605,1393,286,386,54,192,551,1201,183,452,635,195,151,63,220,334,1550
Samaki Walker,206,108,University of Louisville,1976,445,7612,936,2026,503,798,1,9,935,2017,627,1462,2089,252,134,316,403,895,2376
Samardo Samuels,206,117,University of Louisville,1989,109,1722,237,532,164,251,0,4,237,528,148,218,366,45,38,41,115,231,638
Samuel Dalembert,211,115,Seton Hall University,1981,886,21646,2810,5393,1193,1689,1,12,2809,5381,2289,4653,6942,465,437,1546,1271,2601,6814
Sarunas Jasikevicius,193,88,University of Maryland,1976,201,3503,426,1073,293,323,174,496,252,577,49,242,291,571,92,6,296,258,1319
Sarunas Marciulionis*,196,90,NaN,1964,363,8123,1571,3109,1362,1773,127,344,1444,2765,292,527,819,807,459,31,715,971,4631
Sasha Danilovic,196,90,NaN,1970,131,4120,579,1324,297,374,204,550,375,774,70,248,318,251,123,21,269,369,1659
Sasha Kaun,211,117,University of Kansas,1985,25,95,9,17,5,11,0,0,9,17,12,14,26,3,4,5,7,11,23
Sasha Pavlovic,211,122,NaN,1984,598,9250,1099,2723,345,514,320,921,779,1802,189,843,1032,533,282,105,472,1060,2863
Sasha Vujacic,201,88,NaN,1984,648,10556,1314,3352,492,575,630,1713,684,1639,235,1044,1279,880,390,39,394,1016,3750
Scooter McCray,206,97,University of Louisville,1960,30,372,36,75,23,45,0,0,36,75,25,50,75,30,10,7,34,41,95
Scot Pollard,211,120,University of Kansas,1975,506,8372,858,1738,506,714,0,2,858,1736,901,1450,2351,220,299,352,304,1178,2222
Scott Brooks,180,74,"University of California, Irvine",1965,739,10045,1359,3013,628,743,312,840,1047,2173,172,579,751,1724,514,34,498,884,3658
Scott Burrell,201,98,University of Connecticut,1971,440,8531,1069,2592,423,582,380,1025,689,1567,444,1046,1490,601,369,199,390,985,2941
Scott Haffner,190,81,University of Evansville,1966,50,609,96,238,18,27,3,23,93,215,9,46,55,89,16,3,37,57,213
Scott Haskin,211,113,Oregon State University,1970,27,186,21,45,13,19,0,0,21,45,17,38,55,6,2,15,13,33,55
Scott Hastings,208,106,University of Arkansas,1960,479,4710,460,1048,358,432,27,89,433,959,313,663,976,235,113,116,250,783,1305
Scott Machado,185,92,Iona College,1990,6,21,3,6,2,2,0,1,3,5,0,1,1,6,2,0,8,0,8
Scott Meents,208,102,University of Illinois at Urbana-Champaign,1964,39,201,26,72,19,27,1,1,25,71,10,30,40,15,11,7,15,17,72
Scott Padgett,206,108,University of Kentucky,1976,479,5844,695,1714,282,388,248,677,447,1037,418,863,1281,333,187,89,262,716,1920
Scott Roth,203,96,University of Wisconsin,1963,223,2334,307,828,292,405,26,95,281,733,81,187,268,241,111,16,176,319,932
Scott Skiles,185,81,Michigan State University,1964,600,16789,2290,5259,1548,1741,524,1381,1766,3878,275,1251,1526,3881,500,29,1497,1343,6652
Scott Wedman,201,97,University of Colorado,1952,163,2607,515,1092,88,125,35,84,480,1008,126,234,360,183,63,34,104,244,1153
Scott Williams,208,104,University of North Carolina,1968,796,12793,1684,3605,662,924,7,48,1677,3557,1322,2330,3652,449,416,439,565,2020,4037
Scottie Pippen*,203,95,University of Central Arkansas,1965,1178,41069,7420,15700,3122,4437,978,3002,6442,12698,2068,5426,7494,6135,2307,947,3257,3329,18940
Scotty Hopson,201,92,University of Tennessee,1989,2,7,0,4,1,2,0,2,0,2,0,0,0,1,1,0,0,0,1
Sean Colson,183,79,University of North Carolina at Charlotte,1975,26,88,12,48,4,8,2,10,10,38,4,8,12,20,2,0,4,12,30
Sean Elliott,203,92,University of Arizona,1968,742,24502,3852,8290,2251,2816,589,1572,3263,6718,819,2385,3204,1897,576,284,1328,1626,10544
Sean Green,196,95,Iona College,1970,120,1005,216,579,44,68,25,102,191,477,46,73,119,61,51,19,90,84,501
Sean Higgins,206,92,University of Michigan,1968,258,3950,686,1582,195,229,99,315,587,1267,144,360,504,267,89,38,280,409,1666
Sean Kilpatrick,193,95,University of Cincinnati,1990,136,3058,558,1295,328,380,187,549,371,746,47,351,398,219,73,10,200,195,1631
Sean Lampley,201,102,University of California,1979,45,550,69,149,65,94,0,4,69,145,28,66,94,33,7,4,28,45,203
Sean Marks,208,113,University of California,1975,230,2275,259,578,115,173,5,25,254,553,158,343,501,50,33,87,116,342,638
Sean May,206,120,University of North Carolina,1984,119,1868,324,708,170,228,3,13,321,695,155,326,481,115,53,47,134,236,821
Sean Rooks,208,113,University of Arizona,1969,869,15272,1908,4161,1422,2034,3,30,1905,4131,1048,2181,3229,707,292,551,906,1887,5241
Sean Singletary,183,83,University of Virginia,1985,74,606,62,170,36,42,20,50,42,120,20,50,70,58,22,0,46,90,180
Sean Williams,208,106,Boston College,1986,148,2085,243,470,135,210,0,1,243,469,196,301,497,52,51,170,130,342,621
Sebastian Telfair,183,74,NaN,1985,666,13788,1737,4463,821,1056,427,1339,1310,3124,169,858,1027,2239,474,91,973,1371,4722
Sedale Threatt,188,79,West Virginia University Institute of Technology,1961,1045,24473,4307,8886,1440,1770,197,693,4110,8193,403,1462,1865,3991,1259,155,1415,2377,10251
Sedric Toney,188,80,University of Dayton,1962,189,2608,254,697,188,242,57,164,197,533,39,144,183,435,87,1,209,289,753
Semaj Christon,190,86,Xavier University,1992,64,973,77,223,17,31,12,63,65,160,19,69,88,130,28,6,43,79,183
Semih Erden,213,108,NaN,1986,110,1523,163,296,99,161,0,0,163,296,94,214,308,49,40,53,84,268,425
Serge Ibaka,208,106,NaN,1989,682,19943,3500,6852,970,1265,430,1146,3070,5706,1525,3426,4951,459,306,1548,881,1921,8400
Sergei Bazarevich,188,76,NaN,1965,10,74,11,22,7,9,1,6,10,16,1,6,7,14,1,1,7,10,30
Sergei Monia,203,99,NaN,1983,52,686,58,174,20,28,18,68,40,106,22,82,104,38,14,10,24,82,154
Sergey Karasev,201,94,NaN,1993,95,1110,96,243,64,76,31,110,65,133,30,110,140,87,32,4,57,94,287
Sergio Rodriguez,190,79,NaN,1986,419,6329,843,2002,261,354,234,691,609,1311,145,469,614,1395,261,18,605,525,2181
Seth Curry,188,83,Duke University,1990,120,2755,442,936,130,154,189,436,253,500,34,208,242,256,105,10,128,169,1203
Shabazz Muhammad,198,101,"University of California, Los Angeles",1992,235,4354,856,1800,462,617,116,360,740,1440,271,423,694,137,72,21,177,253,2290
Shabazz Napier,185,79,University of Connecticut,1991,159,2124,228,612,115,150,111,314,117,298,34,195,229,294,95,7,168,152,682
Shammond Williams,185,91,University of North Carolina,1975,456,7995,991,2495,413,516,379,1061,612,1434,139,610,749,1147,310,22,492,581,2774
Shandon Anderson,198,94,University of Georgia,1973,785,17117,2094,4583,1082,1458,312,1001,1782,3582,624,1819,2443,1077,596,194,1008,1575,5582
Shane Battier,203,99,Duke University,1978,1059,32379,3211,7328,1258,1699,1352,3521,1859,3807,1363,3092,4455,1902,1057,987,957,2366,9032
Shane Edwards,201,99,University of Arkansas at Little Rock,1987,2,12,1,3,0,0,0,0,1,3,1,1,2,0,0,0,1,1,2
Shane Heal,183,81,NaN,1970,49,308,33,121,7,10,24,83,9,38,3,19,22,38,4,3,22,22,97
Shane Larkin,180,79,University of Miami,1992,202,4105,461,1071,160,210,86,262,375,809,68,330,398,639,214,22,268,317,1168
Shannon Brown,193,92,Michigan State University,1985,506,8297,1344,3211,510,642,299,900,1045,2311,201,651,852,522,330,100,458,633,3497
Shaquille O'Neal*,216,147,Louisiana State University,1972,1268,43666,11661,20015,6105,11590,1,22,11660,19993,4375,9278,13653,3119,771,2820,3491,4374,29428
Shareef Abdur-Rahim,206,102,University of California,1976,915,31566,5935,12569,4379,5372,163,553,5772,12016,2058,4820,6878,2283,888,675,2320,2546,16412
Sharone Wright,211,117,Clemson University,1973,260,5965,1025,2217,586,937,2,15,1023,2202,567,812,1379,156,112,252,464,725,2638
Sharrod Ford,201,95,University of Illinois at Chicago,1972,3,13,2,3,0,0,0,0,2,3,1,2,3,0,0,1,2,7,4
Shaun Livingston,201,87,NaN,1985,812,17574,2169,4473,966,1203,13,76,2156,4397,467,1538,2005,2594,592,307,1080,1507,5317
Shavlik Randolph,208,108,Duke University,1983,173,1381,144,340,89,163,1,11,143,329,174,241,415,41,50,42,65,218,378
Shawn Bradley,229,106,Brigham Young University,1972,984,24148,3506,7713,1640,2321,5,51,3501,7662,2185,4332,6517,688,621,2655,1372,3090,8657
Shawn Kemp,208,104,Trinity Valley Community College,1969,1051,29293,5505,11278,4304,5805,33,119,5472,11159,3026,5808,8834,1704,1185,1279,2766,3826,15347
Shawn Long,206,115,University of Louisiana at Lafayette,1993,18,234,61,109,19,35,7,19,54,90,41,44,85,13,9,9,13,49,148
Shawn Marion,201,99,"University of Nevada, Las Vegas",1978,1295,44882,8071,16631,2554,3174,867,2641,7204,13990,3048,8285,11333,2475,1972,1384,1941,2817,19563
Shawn Respert,185,88,Michigan State University,1972,270,3756,504,1192,206,252,148,435,356,757,132,233,365,278,145,10,203,307,1362
Shawne Williams,185,91,University of North Carolina,1975,377,6455,771,1912,229,297,339,990,432,922,283,828,1111,264,152,177,227,791,2110
Shawnelle Scott,208,113,St. John's University,1972,105,634,78,168,33,71,0,0,78,168,104,124,228,20,14,23,36,123,189
Shayne Whittington,211,113,Western Michigan University,1991,27,149,24,53,19,25,1,8,23,45,15,26,41,9,6,3,10,25,68
Shea Seals,196,95,University of Tulsa,1975,4,9,1,8,2,4,0,3,1,5,3,1,4,0,1,0,0,1,4
Shelden Williams,185,91,University of North Carolina,1975,529,7785,855,1865,611,832,2,13,853,1852,739,1454,2193,226,246,229,416,1033,2323
Sheldon McClellan,196,90,University of Miami,1992,30,287,30,75,23,27,7,30,23,45,4,30,34,15,8,2,5,17,90
Shelton Jones,206,95,St. John's University,1966,102,1364,186,418,116,160,0,2,186,416,64,162,226,84,42,30,94,116,488
Shelvin Mack,190,92,Butler University,1990,413,7255,1064,2476,292,395,265,821,799,1655,93,702,795,1221,248,15,534,504,2685
Sherell Ford,201,95,University of Illinois at Chicago,1972,28,139,30,80,26,34,4,25,26,55,12,12,24,5,8,1,6,27,90
Sherman Douglas,183,81,Syracuse University,1966,886,24235,3797,7824,1834,2687,195,696,3602,7128,626,1289,1915,5144,873,90,2023,1856,9623
Sherron Collins,180,92,University of Kansas,1987,20,66,7,25,1,1,2,10,5,15,0,5,5,8,2,0,4,2,17
Sidney Green,188,83,Duquesne University,1933,669,12909,1927,4247,1063,1435,1,29,1926,4218,1274,2798,4072,634,357,211,998,1706,4918
Sidney Lowe,183,88,North Carolina State University,1960,136,2374,101,308,62,81,2,13,99,295,55,174,229,530,109,4,98,198,266
Sidney Moncrief,190,81,University of Arkansas,1957,375,10411,1784,3664,1539,1828,101,335,1683,3329,456,876,1332,1356,403,103,667,783,5208
Sim Bhullar,226,163,New Mexico State University,1992,3,3,1,2,0,0,0,0,1,2,0,1,1,1,0,1,0,0,2
Skal Labissiere,211,102,University of Kentucky,1996,33,612,117,218,52,74,3,8,114,210,51,111,162,27,16,13,37,64,289
Skeeter Henry,201,86,University of Oklahoma,1967,4,15,1,5,2,4,0,2,1,3,0,2,2,4,0,0,1,1,4
Slavko Vranes,226,124,NaN,1983,1,3,0,1,0,0,0,0,0,1,0,0,0,0,0,0,0,1,0
Sleepy Floyd,190,77,Georgetown University,1960,881,25094,4158,9412,2682,3281,514,1601,3644,7811,560,1822,2382,5312,1054,179,2172,1812,11512
Sly Williams,201,95,University of Rhode Island,1958,40,921,172,401,86,135,4,19,168,382,52,131,183,96,29,9,85,98,434
Smush Parker,193,86,Fordham University,1981,318,7805,990,2356,392,555,310,929,680,1427,127,595,722,890,365,50,559,682,2682
Solomon Alabi,216,113,Florida State University,1988,26,181,16,51,7,10,0,0,16,51,22,39,61,5,4,11,8,16,39
Solomon Hill,201,102,University of Arizona,1991,249,5847,544,1359,304,370,193,575,351,784,169,659,828,394,179,63,243,446,1585
Solomon Jones,208,104,University of South Florida,1984,302,3384,325,706,255,352,1,9,324,697,289,423,712,108,67,165,179,597,906
Sonny Weems,198,92,University of Arkansas,1986,226,3834,556,1216,135,196,49,161,507,1055,95,360,455,306,94,29,239,315,1296
Soumaila Samake,213,104,NaN,1978,47,303,28,72,12,26,0,0,28,72,32,44,76,5,2,19,6,36,68
Speedy Claxton,180,75,Hofstra University,1978,396,10414,1383,3364,989,1307,53,279,1330,3085,231,783,1014,1815,612,48,699,1011,3808
Spencer Dinwiddie,198,90,University of Colorado,1993,105,1948,204,525,176,226,51,176,153,349,35,194,229,311,66,29,106,192,635
Spencer Hawes,216,111,University of Washington,1988,818,18808,2988,6523,834,1141,512,1415,2476,5108,1160,3584,4744,1592,323,776,1193,2023,7322
Spud Webb,168,60,North Carolina State University,1963,891,21750,3089,6851,2071,2441,367,1147,2722,5704,350,1492,1842,4636,974,118,1733,1747,8616
Stacey Augmon,203,92,"University of Nevada, Las Vegas",1968,1061,22600,3142,6700,1973,2713,12,79,3130,6621,1351,2003,3354,1617,1016,334,1312,1837,8269
Stacey King,211,104,University of Oklahoma,1967,498,8562,1228,2603,768,1095,4,19,1224,2584,698,1030,1728,446,206,253,616,1041,3228
Stan Kimbrough,180,69,Xavier University,1966,13,65,9,22,2,2,1,2,8,20,4,3,7,6,5,0,4,5,21
Stanislav Medvedenko,208,113,NaN,1979,263,3340,590,1311,208,281,2,13,588,1298,335,409,744,136,88,42,159,518,1390
Stanley Brundy,198,95,DePaul University,1967,16,128,15,30,7,18,0,0,15,30,15,11,26,3,6,5,6,24,37
Stanley Jackson,190,83,University of Alabama at Birmingham,1970,17,92,17,33,3,3,1,5,16,28,12,15,27,16,5,0,10,13,38
Stanley Johnson,203,99,Murray State University,1944,150,3058,354,965,116,155,108,359,246,606,94,401,495,223,111,36,185,299,932
Stanley Roberts,213,129,Louisiana State University,1970,300,5869,1059,2124,437,850,0,2,1059,2122,506,1043,1549,189,110,385,370,1060,2555
Stefano Rusconi,206,108,NaN,1968,7,30,3,9,2,5,0,0,3,9,3,3,6,3,0,2,3,10,8
Steffond Johnson,203,99,Murray State University,1944,29,234,27,64,20,38,0,3,27,61,15,28,43,5,9,2,18,55,74
Stephane Lasme,203,97,University of Massachusetts Amherst,1982,32,606,64,142,38,64,0,0,64,142,52,54,106,6,26,44,30,70,166
Stephen Curry,190,86,Davidson College,1988,574,19897,4589,9645,1993,2212,1917,4379,2672,5266,405,2097,2502,3916,1029,121,1818,1441,13088
Stephen Graham,198,97,Oklahoma State University,1982,261,3090,399,902,171,220,55,182,344,720,82,369,451,124,62,21,168,383,1024
Stephen Howard,206,102,DePaul University,1970,169,1202,177,347,158,249,0,0,177,347,100,158,258,36,57,40,85,208,512
Stephen Jackson,190,83,University of Alabama at Birmingham,1970,1061,34218,5772,13899,3191,4001,1530,4637,4242,9262,835,3279,4114,3339,1379,407,2686,2539,16265
Stephen Thompson,193,83,Syracuse University,1968,38,182,28,74,6,16,0,2,28,72,22,16,38,16,12,6,10,18,62
Stephen Zimmerman,213,108,"University of Nevada, Las Vegas",1996,19,108,10,31,3,5,0,0,10,31,11,24,35,4,2,5,3,17,23
Stephon Marbury,188,81,Georgia Institute of Technology,1977,976,37040,6745,15593,4346,5518,1144,3519,5601,12074,674,2247,2921,7627,1210,138,2960,2311,18980
Steve Alford,188,83,Indiana University,1964,235,2547,439,958,177,207,55,163,384,795,35,181,216,268,130,13,134,170,1110
Steve Bardo,196,86,University of Illinois at Urbana-Champaign,1968,33,299,28,85,16,23,1,10,27,75,13,47,60,44,12,4,22,45,73
Steve Blake,190,78,University of Maryland,1980,1087,26705,2620,6529,615,801,1299,3421,1321,3108,305,2026,2331,4541,760,85,1581,1616,7154
Steve Bucknall,198,97,University of North Carolina,1966,18,75,9,33,5,6,0,1,9,32,5,2,7,10,2,1,11,10,23
Steve Burtt,188,83,Iona College,1962,101,1121,218,512,146,210,2,14,216,498,28,64,92,123,49,13,110,195,584
Steve Colter,190,74,New Mexico State University,1962,664,12405,1667,3729,810,1041,83,290,1584,3439,378,954,1332,1953,581,102,692,1128,4227
Steve Francis,190,88,University of Maryland,1977,646,24025,3876,9032,3099,3893,600,1767,3276,7265,1034,2471,3505,3818,920,240,2244,2017,11451
Steve Goodrich,208,99,Princeton University,1976,21,183,9,28,5,9,1,3,8,25,8,18,26,11,3,3,11,24,24
Steve Hamer,213,111,University of Tennessee,1973,35,268,30,57,16,29,0,2,30,55,17,43,60,7,2,4,13,39,76
Steve Harris,196,88,University of Tulsa,1963,265,3924,815,1850,344,416,1,27,814,1823,207,284,491,325,166,37,225,354,1975
Steve Hayes,213,92,Idaho State University,1955,69,498,49,105,13,40,0,0,49,105,43,68,111,8,6,23,18,100,111
Steve Henson,180,80,Kansas State University,1968,238,2282,254,631,126,145,105,243,149,388,46,130,176,465,88,2,175,283,739
Steve Johnson,203,99,Murray State University,1944,413,9105,1821,3278,1121,1716,0,4,1821,3274,758,1470,2228,527,177,294,967,1463,4763
Steve Kerr,190,79,University of Arizona,1965,962,16688,2095,4385,649,750,732,1625,1363,2760,191,914,1105,1728,486,47,531,883,5571
Steve Nash,190,88,Santa Clara University,1974,1217,38069,6321,12892,3060,3384,1685,3939,4636,8953,643,2999,3642,10335,899,102,3478,1982,17387
Steve Novak,208,102,Marquette University,1983,542,6113,816,1858,109,125,627,1446,189,412,74,572,646,146,92,45,91,411,2368
Steve Scheffler,206,113,Purdue University,1967,185,979,127,226,97,128,1,5,126,221,91,103,194,26,33,9,35,141,352
Steve Smith,201,90,Michigan State University,1969,1072,32270,5139,11738,3445,4076,1326,3729,3813,8009,1231,2170,3401,3267,802,315,1896,2585,15049
Steve Stipanovich,211,111,University of Missouri,1960,322,10165,1623,3344,1100,1368,7,40,1616,3304,655,1914,2569,768,342,313,616,1132,4353
Steven Adams,213,115,University of Pittsburgh,1993,311,7371,945,1665,453,794,0,3,945,1662,842,1161,2003,257,208,310,400,843,2343
Steven Hill,213,112,University of Arkansas,1985,1,2,1,1,0,0,0,0,1,1,2,1,3,0,0,0,0,0,2
Steven Hunter,213,99,DePaul University,1981,400,5993,735,1313,347,715,0,1,735,1312,482,782,1264,79,49,422,249,656,1817
Steven Smith,201,90,Michigan State University,1969,8,28,2,8,1,2,0,0,2,8,1,5,6,0,1,0,2,4,5
Stevin Smith,201,90,Michigan State University,1969,8,60,6,18,1,1,1,6,5,12,2,8,10,4,1,0,4,9,14
Stewart Granger,190,86,Villanova University,1961,24,258,26,71,13,19,0,4,26,67,7,16,23,39,9,1,34,30,65
Stojko Vrankovic,218,117,NaN,1964,170,2050,197,413,79,132,0,0,197,413,155,361,516,59,22,179,132,318,473
Stromile Swift,206,102,Louisiana State University,1979,622,11833,1872,3944,1240,1785,3,30,1869,3914,965,1815,2780,304,373,745,757,1510,4987
Stuart Gray,213,106,"University of California, Los Angeles",1963,444,4017,380,857,262,394,0,12,380,845,349,816,1165,167,79,159,267,735,1022
Sun Yue,206,92,NaN,1985,10,28,3,11,0,0,0,6,3,5,0,0,0,2,1,1,3,10,6
Sundiata Gaines,185,83,University of Georgia,1986,137,1612,224,563,118,214,53,184,171,379,59,154,213,249,99,4,120,125,619
Sylvester Gray,198,104,University of Memphis,1967,55,1220,167,398,105,156,1,4,166,394,117,169,286,117,36,25,102,144,440
T.J. Ford,201,92,NaN,1977,429,11882,1829,4223,1012,1242,127,439,1702,3784,296,1035,1331,2495,496,55,1047,972,4797
T.J. McConnell,208,108,NaN,1994,162,3739,454,976,99,131,42,144,412,832,82,419,501,901,229,20,299,253,1049
T.J. Warren,208,108,NaN,1995,153,3732,737,1469,178,237,59,189,678,1280,223,348,571,144,131,64,116,320,1711
T.R. Dunn,201,104,NaN,1954,442,9352,612,1348,272,372,1,12,611,1336,619,888,1507,650,561,68,207,885,1497
Taj Gibson,206,102,University of Southern California,1985,663,16646,2635,5296,1056,1516,7,48,2628,5248,1532,2644,4176,650,351,777,836,1657,6333
Tamar Slay,203,97,Marshall University,1980,66,517,73,202,14,26,13,49,60,153,24,46,70,31,26,4,39,71,173
Tang Hamilton,203,99,Mississippi State University,1978,9,98,10,19,0,1,0,1,10,18,6,12,18,5,4,0,2,10,20
Tarence Kinsey,198,83,University of South Carolina,1984,109,1340,186,411,116,142,23,71,163,340,42,105,147,53,68,1,71,102,511
Tarik Black,206,113,University of Kansas,1991,232,3979,521,944,231,390,1,4,520,940,471,764,1235,139,82,110,176,567,1274
Tariq Abdul-Wahad,198,101,San Jose State University,1974,321,6826,1049,2519,542,755,22,101,1027,2418,428,723,1151,388,263,121,442,688,2662
Tate George,196,86,University of Connecticut,1968,177,2019,297,717,141,172,1,14,296,703,65,115,180,325,76,11,157,182,736
Taurean Green,183,80,University of Florida,1986,34,148,14,50,22,24,4,22,10,28,0,20,20,22,4,0,18,10,54
Taurean Waller-Prince,183,88,NaN,1994,59,981,114,285,74,94,33,102,81,183,25,132,157,55,43,27,61,96,335
Taylor Griffin,201,107,University of Oklahoma,1986,8,32,4,10,2,4,0,2,4,8,0,2,2,1,0,2,1,4,10
Tayshaun Prince,206,96,University of Kentucky,1980,1157,35604,5119,11304,1682,2228,638,1711,4481,9593,1249,3657,4906,2695,648,541,1188,1392,12558
Tellis Frank,208,102,Western Kentucky University,1965,264,4703,639,1456,432,583,0,4,639,1452,363,659,1022,276,158,95,326,795,1710
Terence Morris,206,100,University of Maryland,1979,139,1934,209,514,32,45,22,112,187,402,123,254,377,93,35,49,81,126,472
Terence Stansbury,196,77,Temple University,1961,192,2984,468,1055,240,308,24,107,444,948,76,201,277,390,119,20,248,483,1200
Terrance Roberson,201,97,"California State University, Fresno",1976,3,13,0,2,0,0,0,1,0,1,0,1,1,1,0,0,2,3,0
Terrel Harris,196,86,Oklahoma State University,1987,62,592,37,137,28,41,8,55,29,82,26,77,103,44,13,8,59,68,110
Terrell Brandon,180,81,University of Oregon,1970,760,22762,4120,9227,1849,2121,406,1157,3714,8070,452,1856,2308,4716,1205,236,1493,1407,10495
Terrence Jones,206,114,University of Kentucky,1992,286,6827,1215,2454,471,762,112,386,1103,2068,460,1176,1636,295,186,324,266,458,3013
Terrence Rencher,190,83,University of Texas at Austin,1973,72,810,66,200,62,92,18,58,48,142,18,70,88,108,32,4,86,74,212
Terrence Ross,201,93,University of Washington,1991,465,11147,1735,4079,333,412,786,2115,949,1964,167,1054,1221,450,390,157,387,847,4589
Terrence Williams,198,99,University of Louisville,1987,204,3762,565,1374,194,299,80,251,485,1123,84,614,698,467,112,26,298,259,1404
Terry Catledge,203,99,University of South Alabama,1963,515,13541,2576,5311,1365,2087,3,32,2573,5279,1479,1835,3314,459,285,99,886,1285,6520
Terry Cummings,206,99,DePaul University,1961,1106,29645,6824,14256,2721,3869,44,146,6780,14110,2654,4738,7392,1921,1072,541,1829,3425,16413
Terry Davis,206,102,Virginia Union University,1967,480,10369,1202,2545,654,1081,3,19,1199,2526,1106,1781,2887,273,183,149,518,1176,3061
Terry Dehere,188,86,Seton Hall University,1971,428,7596,1113,2717,748,961,344,906,769,1811,151,461,612,1061,220,39,633,860,3318
Terry Dozier,206,95,University of South Carolina,1966,9,92,9,27,4,8,0,1,9,26,7,8,15,3,6,2,7,10,22
Terry Mills,208,104,University of Michigan,1967,733,17241,2981,6515,995,1280,533,1391,2448,5124,1111,2798,3909,924,432,325,894,1996,7490
Terry Porter,190,88,University of Wisconsin-Stevens Point,1963,1274,35354,5428,11734,3433,4107,1297,3360,4131,8374,715,3157,3872,7160,1583,181,2666,2203,15586
Terry Rozier,188,86,University of Louisville,1994,113,1574,180,517,59,76,63,206,117,311,64,226,290,168,51,12,66,92,482
Terry Teagle,196,88,Baylor University,1960,567,12534,2889,6136,1263,1585,15,91,2874,6045,646,928,1574,757,464,110,821,1316,7056
Terry Tyler,201,97,University of Detroit Mercy,1956,379,7827,1399,2935,379,526,3,30,1396,2905,534,981,1515,326,235,362,342,677,3180
Thabo Sefolosha,201,99,NaN,1984,806,18664,1842,4142,649,876,456,1340,1386,2802,622,2495,3117,1222,891,382,749,1379,4789
Thaddeus Young,203,100,Georgia Institute of Technology,1988,815,25028,4777,9624,1246,1841,336,1025,4441,8599,1588,3188,4776,1307,1182,321,1183,1784,11136
Thanasis Antetokounmpo,201,92,NaN,1992,2,6,3,4,0,0,0,1,3,3,0,1,1,0,0,0,0,2,6
Tharon Mayes,190,79,Florida State University,1968,48,510,60,198,48,72,30,82,30,116,6,26,32,70,32,4,62,82,198
Theo Ratliff,208,102,University of Wyoming,1973,1052,26855,2890,5834,1799,2556,0,3,2890,5831,2050,3953,6003,632,516,2631,1299,3026,7579
Theron Smith,203,102,Ball State University,1980,53,688,60,179,20,24,9,24,51,155,52,105,157,35,11,9,41,76,149
Thomas Gardner,196,102,University of Missouri,1985,20,143,18,59,2,6,7,35,11,24,3,8,11,3,4,1,7,8,45
Thomas Hamilton,218,149,University of Pittsburgh,1975,33,343,44,110,19,41,0,0,44,110,41,71,112,16,4,23,37,37,107
Thomas Jordan,208,99,Oklahoma State University,1968,4,106,18,41,8,17,0,0,18,41,5,14,19,3,3,5,12,14,44
Thomas Robinson,208,107,University of Kansas,1991,437,6058,904,1942,361,706,0,9,904,1933,759,1366,2125,269,234,157,466,774,2169
Thon Maker,216,97,NaN,1997,57,562,83,181,32,49,28,74,55,107,40,74,114,23,10,26,17,84,226
Thurl Bailey,211,97,North Carolina State University,1961,931,24968,4819,10302,2451,3016,4,37,4815,10265,1311,3428,4739,1247,432,1081,1447,1810,12093
Tiago Splitter,211,111,NaN,1985,355,6812,1073,1932,668,958,2,14,1071,1918,576,1203,1779,423,198,209,384,685,2816
Tibor Pleiss,221,116,NaN,1989,12,82,11,25,2,2,0,2,11,23,6,9,15,2,1,2,8,19,24
Tierre Brown,188,85,McNeese State University,1979,134,1654,202,526,93,121,30,85,172,441,41,125,166,266,64,4,143,95,527
Tim Breaux,201,97,University of Wyoming,1970,102,940,108,293,61,96,22,74,86,219,38,58,96,41,24,13,47,68,299
Tim Duncan,211,113,Wake Forest University,1976,1392,47368,10285,20334,5896,8468,30,168,10255,20166,3859,11232,15091,4225,1025,3020,3381,3304,26496
Tim Frazier,185,77,Pennsylvania State University,1990,189,3485,397,984,224,319,82,258,315,726,98,351,449,779,138,10,281,331,1100
Tim Hardaway,183,79,University of Texas at El Paso,1966,1296,41335,7387,17269,3314,4219,2251,6349,5136,10920,666,3129,3795,8439,1757,199,3085,2751,20339
Tim James,201,96,University of Miami,1976,43,261,26,79,15,23,1,3,25,76,23,23,46,11,2,9,13,33,68
Tim Kempton,208,111,University of Notre Dame,1964,301,3941,475,1000,352,523,0,3,475,997,255,570,825,319,128,48,304,646,1302
Tim Legler,193,90,La Salle University,1966,343,5888,867,1946,455,545,282,668,585,1278,153,387,540,448,173,47,222,572,2471
Tim McCormick,211,108,University of Michigan,1962,553,12504,1895,3541,1080,1545,1,18,1894,3523,923,1910,2833,609,171,210,730,1490,4871
Tim Ohlbrecht,211,115,NaN,1988,3,12,1,3,1,1,0,0,1,3,0,1,1,1,1,0,4,1,3
Tim Perry,206,90,Temple University,1965,511,9690,1344,2775,570,881,96,297,1248,2478,748,1211,1959,444,225,427,501,816,3354
Tim Quarterman,198,88,Louisiana State University,1994,16,80,13,29,0,3,5,13,8,16,4,10,14,11,2,3,11,6,31
Tim Thomas,208,104,Villanova University,1977,1033,26150,4255,9714,1937,2572,1180,3171,3075,6543,984,3173,4157,1530,746,350,1482,2786,11627
Tim Young,213,99,Stanford University,1976,25,137,13,39,28,36,0,0,13,39,13,22,35,5,2,1,9,18,54
Timofey Mozgov,216,124,NaN,1986,549,10391,1555,2907,770,1052,9,46,1546,2861,986,1853,2839,309,182,492,645,1270,3889
Timothe Luwawu-Cabarrot,198,92,NaN,1995,69,1190,145,361,105,123,50,161,95,200,25,124,149,75,32,10,73,154,445
Tito Horford,216,111,University of Miami,1966,63,376,33,110,27,43,0,0,33,110,29,55,84,5,7,26,30,50,93
Tito Maddox,193,86,"California State University, Fresno",1981,9,35,3,12,5,8,0,3,3,9,1,6,7,5,3,1,3,4,11
Tobias Harris,190,86,University of New Orleans,1967,515,14889,2664,5699,1234,1529,462,1396,2202,4303,592,2373,2965,846,377,274,667,1001,7024
Toby Bailey,198,96,"University of California, Los Angeles",1975,73,698,92,226,54,78,3,15,89,211,50,76,126,43,22,6,35,79,241
Tod Murphy,206,99,"University of California, Irvine",1963,200,4138,402,884,242,358,18,62,384,822,344,607,951,187,115,88,113,392,1064
Todd Day,198,85,University of Arkansas,1970,562,14021,2335,5834,1501,2014,668,1948,1667,3886,648,1225,1873,820,613,342,826,1573,6839
Todd Fuller,193,81,Pepperdine University,1958,225,2500,317,752,201,301,0,4,317,748,240,434,674,46,34,60,146,351,835
Todd Lichti,193,92,Stanford University,1967,250,4366,753,1646,401,513,21,80,732,1566,185,342,527,336,186,46,259,433,1928
Todd MacCulloch,213,127,University of Washington,1976,223,3439,568,1049,233,363,0,0,568,1049,340,548,888,121,61,177,154,478,1369
Todd Mitchell,201,92,Purdue University,1966,48,706,86,194,74,128,0,0,86,194,36,64,100,42,32,4,66,102,246
Todd Mundt,213,113,Delta State University,1970,66,302,32,82,10,16,0,0,32,82,22,34,56,6,4,10,6,58,74
Tom Chambers,208,99,University of Utah,1959,865,26005,5751,12484,4054,4859,227,718,5524,11766,1294,3797,5091,1812,701,473,1903,2759,15783
Tom Copa,208,124,Marquette University,1964,33,132,22,40,4,13,0,0,22,40,14,22,36,3,2,6,8,29,48
Tom Garrick,188,83,University of Rhode Island,1966,291,5267,602,1302,286,372,6,64,596,1238,135,422,557,951,302,26,387,501,1496
Tom Gugliotta,208,108,North Carolina State University,1969,942,27909,4411,9865,2172,2893,277,948,4134,8917,1881,4658,6539,2550,1283,583,2020,2272,11271
Tom Hammonds,206,97,Georgia Institute of Technology,1967,741,11132,1515,3161,835,1216,0,12,1515,3149,771,1599,2370,402,185,148,563,1321,3865
Tom Hovasse,203,92,Pennsylvania State University,1967,2,4,0,1,0,0,0,1,0,0,0,0,0,0,1,0,0,1,0
Tom LaGarde,208,99,University of North Carolina,1955,1,8,0,1,1,2,0,0,0,1,1,1,2,0,0,0,1,2,1
Tom McMillen,211,97,University of Maryland,1952,125,2410,383,819,176,214,0,8,383,811,108,215,323,87,17,27,78,248,942
Tom Scheffler,211,108,Purdue University,1954,39,268,21,51,10,20,0,0,21,51,18,58,76,11,8,11,15,48,52
Tom Sewell,196,83,Lamar University,1962,21,87,9,36,2,4,0,2,9,34,2,2,4,6,3,1,7,13,20
Tom Sluby,193,90,University of Notre Dame,1962,31,151,30,58,13,21,0,2,30,56,5,7,12,16,3,0,11,18,73
Tom Tolbert,201,106,University of Arizona,1965,312,5680,757,1647,487,680,29,98,728,1549,406,845,1251,285,116,109,347,741,2030
Tomas Satoransky,201,95,NaN,1991,57,719,61,146,23,33,9,37,52,109,25,58,83,92,26,6,38,60,154
Toney Douglas,188,88,Florida State University,1986,516,9475,1354,3361,480,578,557,1574,797,1787,265,835,1100,1108,439,38,525,1001,3745
Toni Kukoc,208,87,NaN,1968,967,25593,4205,9437,2106,2912,845,2509,3360,6928,1157,2930,4087,3583,942,329,1801,1675,11361
Tony Allen,193,96,Oklahoma State University,1982,798,17782,2544,5356,1342,1888,121,432,2423,4924,1001,1836,2837,1068,1147,334,1099,1898,6551
Tony Battie,211,104,Texas Tech University,1976,910,19127,2313,4771,850,1226,14,83,2299,4688,1494,3152,4646,580,446,780,767,2362,5490
Tony Bennett,183,79,University of Wisconsin-Green Bay,1969,152,1886,221,536,41,56,55,164,166,372,28,127,155,303,69,1,93,200,538
Tony Bobbitt,193,86,University of Cincinnati,1979,2,12,2,5,0,0,1,2,1,3,0,3,3,0,0,0,0,1,5
Tony Brown,198,83,University of Arkansas,1960,490,7320,1042,2416,499,686,62,230,980,2186,430,507,937,653,283,49,460,922,2645
Tony Campbell,201,97,Ohio State University,1962,753,16394,3407,7493,1661,2104,74,292,3333,7201,988,1315,2303,1101,632,172,1167,1670,8549
Tony Dawson,201,97,Florida State University,1967,6,30,7,15,1,1,2,4,5,11,2,3,5,1,0,0,3,4,17
Tony Delk,185,85,University of Kentucky,1974,709,15215,2485,6140,946,1233,601,1794,1884,4346,459,1320,1779,1361,586,100,760,1084,6517
Tony Dumas,198,86,University of Missouri-Kansas City,1972,180,2500,442,1109,236,387,106,340,336,769,97,117,214,211,75,21,164,301,1226
Tony Farmer,206,110,University of Nebraska,1970,101,1368,144,365,234,304,10,53,134,312,134,193,327,79,76,20,91,190,532
Tony Harris,190,86,University of New Orleans,1967,14,147,16,55,33,38,3,12,13,43,3,8,11,8,5,0,10,15,68
Tony Massenburg,206,99,University of Maryland,1967,755,13844,1862,3941,1081,1535,1,14,1861,3927,1188,2153,3341,296,290,343,767,1768,4806
Tony Mitchell,201,92,Purdue University,1966,24,89,8,17,11,19,1,2,7,15,16,11,27,3,7,3,4,9,28
Tony Parker,188,83,NaN,1982,1143,36205,7386,14979,3254,4323,496,1515,6890,13464,420,2798,3218,6634,1003,90,2722,1954,18522
Tony Smith,201,95,NaN,1968,516,8233,1133,2636,378,553,158,507,975,2129,354,476,830,1035,356,89,508,823,2802
Tony Snell,201,90,University of New Mexico,1991,293,6280,660,1587,152,187,330,885,330,702,91,656,747,289,131,57,199,395,1802
Tony White,188,77,University of Tennessee,1965,98,1162,222,498,78,108,0,12,222,486,24,38,62,118,40,4,94,114,522
Tony Wroten,198,92,University of Washington,1993,145,3076,575,1393,370,572,84,363,491,1030,106,257,363,437,137,28,375,268,1604
Torgeir Bryn,206,113,Texas State University,1964,3,10,0,2,4,6,0,0,0,2,0,2,2,0,2,1,1,5,4
Tornike Shengelia,206,98,NaN,1991,71,401,36,79,15,32,1,14,35,65,17,38,55,31,9,3,35,47,88
Torraye Braggs,203,111,Xavier University,1976,37,332,35,73,16,24,0,0,35,73,43,47,90,14,8,4,28,62,86
Toure' Murry,196,88,Wichita State University,1989,61,409,60,139,27,43,5,12,55,127,15,31,46,51,21,1,42,50,152
Tracy McGrady,203,95,NaN,1979,968,31331,6800,15648,3929,5265,1097,3262,5703,12386,1322,4048,5370,4260,1151,821,2073,1701,18626
Tracy Moore,193,90,University of Tulsa,1965,119,1729,298,738,160,191,77,224,221,514,75,108,183,121,62,8,98,186,833
Tracy Murray,201,102,"University of California, Los Angeles",1971,764,13207,2370,5551,894,1083,824,2131,1546,3420,547,1242,1789,550,387,172,664,1225,6458
Trajan Langdon,190,89,Duke University,1976,119,1738,220,529,121,133,86,217,134,312,29,130,159,152,56,14,98,179,647
Travis Best,180,82,Georgia Institute of Technology,1972,782,16897,2230,5160,1210,1440,287,831,1943,4329,250,1150,1400,2768,750,67,1027,1789,5957
Travis Diener,185,79,Marquette University,1982,188,2711,300,778,95,115,165,472,135,306,39,207,246,440,80,9,99,202,860
Travis Hansen,198,92,Brigham Young University,1978,41,507,46,130,22,27,9,30,37,100,30,40,70,19,10,9,15,67,123
Travis Knight,213,106,University of Connecticut,1974,371,4566,522,1192,217,312,15,58,507,1134,441,719,1160,224,136,220,244,805,1276
Travis Leslie,193,92,University of Georgia,1990,10,45,5,14,4,9,0,0,5,14,6,3,9,5,2,2,2,4,14
Travis Mays,188,86,University of Texas at Austin,1968,115,2964,429,1047,311,415,104,287,325,760,75,158,233,326,102,14,213,232,1273
Travis Outlaw,206,95,NaN,1984,656,13756,2104,4994,990,1324,384,1126,1720,3868,513,1582,2095,548,349,398,544,1078,5582
Travis Wear,208,104,"University of California, Los Angeles",1990,51,672,84,209,20,26,11,30,73,179,31,75,106,40,15,11,35,55,199
Travis Williams,198,97,South Carolina State University,1969,47,427,62,132,27,50,0,1,62,131,59,52,111,22,20,6,36,65,151
Tree Rollins,216,106,Clemson University,1955,637,10325,902,1777,374,502,0,5,902,1772,787,1816,2603,225,207,865,418,1374,2178
Tremaine Fowlkes,203,99,"California State University, Fresno",1976,103,1233,105,257,87,110,4,20,101,237,94,134,228,54,47,6,50,146,301
Trent Tucker,196,87,University of Minnesota,1959,615,12613,2070,4535,405,530,555,1364,1515,3171,394,780,1174,1199,560,74,469,1235,5100
Trenton Hassell,196,90,Austin Peay State University,1979,707,17051,1606,3615,555,726,97,308,1509,3307,561,1348,1909,1173,295,275,619,1489,3864
Treveon Graham,198,99,Virginia Commonwealth University,1993,27,189,19,40,10,15,9,15,10,25,5,17,22,6,6,1,3,18,57
Trevor Ariza,203,97,"University of California, Los Angeles",1985,967,27084,3461,8115,1532,2163,1149,3282,2312,4833,1035,3511,4546,1954,1414,304,1313,1902,9603
Trevor Booker,203,103,Clemson University,1987,464,9714,1371,2660,442,706,67,213,1304,2447,911,1702,2613,484,328,256,481,944,3251
Trevor Ruffin,185,83,University of Hawaii,1970,110,1870,347,845,175,220,142,383,205,462,29,126,155,317,57,4,196,184,1011
Trevor Wilson,201,95,"University of California, Los Angeles",1968,160,2830,423,906,211,376,0,6,423,900,273,353,626,171,88,25,210,280,1057
Trevor Winter,213,124,University of Minnesota,1974,1,5,0,0,0,0,0,0,0,0,1,2,3,0,0,0,0,5,0
Trey Burke,185,86,University of Michigan,1992,267,6619,1089,2791,300,369,354,1052,735,1739,93,478,571,972,153,32,383,404,2832
Trey Gilder,206,83,Northwestern State University,1985,2,5,1,1,0,0,0,0,1,1,0,1,1,0,1,0,0,0,2
Trey Johnson,196,98,Jackson State University,1984,31,263,32,85,27,29,2,6,30,79,7,20,27,26,3,2,16,38,93
Trey Lyles,208,106,University of Kentucky,1995,151,2540,350,875,114,161,114,332,236,543,107,427,534,129,52,38,129,211,928
Trey Thompkins,206,107,University of Texas at Austin,1991,24,119,24,61,5,7,4,13,20,48,4,20,24,3,3,3,6,10,57
Tristan Thompson,206,107,University of Texas at Austin,1991,466,13381,1723,3347,932,1525,0,9,1723,3338,1591,2436,4027,385,240,364,520,1123,4378
Troy Bell,185,81,Boston College,1980,6,34,4,18,3,3,0,4,4,14,3,1,4,4,1,0,6,6,11
Troy Daniels,193,92,Virginia Commonwealth University,1991,209,2528,411,1043,70,89,295,738,116,305,44,183,227,116,44,9,112,216,1187
Troy Hudson,185,77,Southern Illinois University,1976,517,11280,1714,4278,757,882,452,1333,1262,2945,193,684,877,1748,273,30,818,690,4637
Troy Murphy,211,111,University of Notre Dame,1980,832,22239,3156,7095,1679,2152,676,1758,2480,5337,1495,4740,6235,1237,539,339,984,2133,8667
Troy Williams,198,97,South Carolina State University,1969,60,1114,146,334,42,64,36,124,110,210,30,108,138,50,54,20,66,120,370
Truck Robinson,201,102,Tennessee State University,1951,2,35,2,5,0,2,0,0,2,5,6,3,9,3,2,3,5,3,4
Ty Lawson,180,88,University of North Carolina,1987,617,17499,2635,5778,1571,2050,509,1427,2126,4351,377,1249,1626,3554,689,59,1254,985,7350
Tyler Ennis,190,87,Syracuse University,1994,218,2652,368,891,77,98,91,265,277,626,47,190,237,413,113,15,220,252,904
Tyler Hansbrough,206,113,University of North Carolina,1985,428,7233,947,2156,984,1333,3,22,944,2134,745,1063,1808,181,207,91,319,869,2881
Tyler Honeycutt,203,85,"University of California, Los Angeles",1990,24,120,11,35,5,7,1,5,10,30,6,18,24,9,4,4,7,5,28
Tyler Johnson,193,84,"California State University, Fresno",1992,141,3644,545,1234,278,365,138,369,407,865,92,391,483,354,141,67,167,284,1506
Tyler Ulis,178,68,University of Kentucky,1996,61,1123,184,437,55,71,21,79,163,358,20,75,95,226,48,5,77,73,444
Tyler Zeller,213,114,University of North Carolina,1990,340,6048,957,1916,470,611,0,6,957,1910,513,974,1487,316,88,203,297,751,2384
Tyreke Evans,198,99,University of Memphis,1989,513,16021,3037,6879,1617,2138,351,1164,2686,5715,436,1955,2391,2541,654,196,1315,1155,8042
Tyrone Corbin,198,95,DePaul University,1962,1363,34057,4789,10471,2207,2774,203,695,4586,9776,2185,4142,6327,2330,1500,333,1644,3277,11988
Tyrone Hill,206,108,Xavier University,1968,895,24843,3085,6217,1999,3131,0,13,3085,6204,2637,4895,7532,723,694,421,1371,3210,8169
Tyrone Nesby,198,102,"University of Nevada, Las Vegas",1976,317,8215,1107,2801,489,629,240,784,867,2017,346,768,1114,446,315,113,334,822,2943
Tyronn Lue,183,79,University of Nebraska,1977,718,15828,2244,5108,901,1084,581,1478,1663,3630,161,1031,1192,2183,338,11,814,1345,5970
Tyrus Thomas,206,97,Louisiana State University,1986,456,9152,1341,3040,911,1255,8,37,1333,3003,631,1642,2273,403,391,610,619,1118,3601
Tyshawn Taylor,190,83,University of Kansas,1990,61,491,63,178,39,57,9,25,54,153,5,28,33,57,25,1,56,54,174
Tyson Chandler,216,108,NaN,1982,1033,29372,3362,5660,2278,3521,0,10,3362,5650,3279,6397,9676,871,587,1277,1549,3020,9002
Tyson Wheeler,178,74,University of Rhode Island,1975,1,3,1,1,1,2,1,1,0,0,0,0,0,2,0,0,0,1,4
Tyus Edney,178,68,"University of California, Los Angeles",1973,226,4743,583,1438,497,617,65,202,518,1236,122,271,393,910,217,6,395,387,1728
Tyus Jones,188,88,Duke University,1996,97,1347,131,337,61,82,42,126,89,211,17,97,114,264,78,8,71,83,365
Udonis Haslem,203,106,University of Florida,1980,831,21372,2625,5341,1225,1621,3,35,2622,5306,1600,4101,5701,721,421,247,798,2025,6478
Uros Slokar,208,107,NaN,1983,20,72,14,26,9,13,1,2,13,24,7,7,14,1,1,2,9,11,38
Uwe Blab,216,114,Indiana University,1962,282,2497,224,525,155,259,0,0,224,525,157,364,521,127,20,107,176,446,603
Vander Blue,193,90,Marquette University,1992,5,89,11,34,3,10,2,11,9,23,2,10,12,9,3,0,8,5,27
Vassilis Spanoulis,193,88,NaN,1982,31,272,23,72,34,42,5,29,18,43,5,17,22,28,7,1,29,33,85
Vern Fleming,196,83,University of Georgia,1962,893,24721,3964,7954,2159,2826,38,210,3926,7744,979,2033,3012,4293,926,105,1795,2003,10125
Vernon Macklin,208,102,University of Florida,1986,23,135,19,35,8,14,0,0,19,35,14,20,34,5,4,4,3,9,46
Vernon Maxwell,193,81,University of Florida,1965,1019,27592,4383,10986,1997,2749,1355,4259,3028,6727,446,2105,2551,3309,1096,169,1881,2049,12118
Viacheslav Kravtsov,213,117,NaN,1987,45,283,41,61,15,45,0,0,41,61,33,29,62,10,5,10,20,39,97
Victor Alexander,206,120,Iowa State University,1969,286,5755,1101,2126,322,508,18,63,1083,2063,446,938,1384,257,135,177,378,713,2542
Victor Claver,206,101,NaN,1988,80,1072,100,251,24,41,34,116,66,135,43,135,178,56,30,16,58,103,258
Victor Oladipo,193,95,Indiana University,1992,291,9661,1702,3924,831,1039,383,1108,1319,2816,181,1086,1267,1080,443,131,732,726,4618
Viktor Khryapa,206,95,NaN,1982,143,2351,251,567,127,193,14,48,237,519,168,324,492,142,86,48,139,353,643
Vin Baker,211,105,University of Hartford,1971,872,27254,4913,10149,2539,3961,40,185,4873,9964,2392,3794,6186,1585,613,834,1850,2758,12405
Vince Carter,198,99,University of North Carolina,1977,1497,48014,9961,22716,5249,6583,2292,6119,7669,16597,1751,5065,6816,4983,1597,878,2731,4104,27463
Vincent Askew,198,95,University of Memphis,1966,583,11328,1448,3029,980,1305,85,283,1363,2746,487,948,1435,1229,361,131,618,1230,3961
Vincent Yarbrough,201,95,University of Tennessee,1981,59,1381,168,428,49,62,21,78,147,350,36,126,162,130,57,33,81,145,406
Vincenzo Esposito,190,89,NaN,1969,30,282,36,100,31,39,13,56,23,44,4,12,16,23,7,0,39,27,116
Vinnie Johnson,188,90,Baylor University,1956,627,15957,3255,7257,1174,1632,64,250,3191,7007,860,1079,1939,2074,562,136,928,1265,7748
Vinny Del,198,88,NaN,1963,836,20133,2969,6265,1110,1317,244,690,2725,5575,296,1596,1892,2610,602,68,854,1544,7292
Vitaly Potapenko,208,127,Wright State University,1975,693,13355,1880,3907,817,1203,1,7,1879,3900,1208,1913,3121,502,295,247,902,1756,4578
Vitor Faverani,211,117,NaN,1988,37,488,64,147,24,37,12,40,52,107,42,86,128,16,14,27,41,74,164
Vlade Divac,216,110,NaN,1968,1134,33838,5205,10510,2888,4176,100,426,5105,10084,2881,6445,9326,3541,1288,1631,2470,3609,13398
Vladimir Radmanovic,208,102,NaN,1980,933,20474,2709,6559,768,1006,1244,3291,1465,3268,814,2728,3542,1260,673,314,1072,1970,7430
Vladimir Stepania,213,107,NaN,1976,270,3726,455,1071,206,384,2,15,453,1056,444,736,1180,94,110,144,213,482,1118
Voise Winters,203,90,Bradley University,1962,4,17,3,13,0,0,0,1,3,12,1,2,3,0,1,0,2,1,6
Von Wafer,196,95,Florida State University,1985,229,2629,407,989,180,241,106,340,301,649,39,214,253,153,75,22,141,162,1100
Vonteego Cummings,190,83,University of Pittsburgh,1976,199,3789,521,1359,230,317,109,340,412,1019,118,255,373,534,176,32,259,387,1381
Voshon Lenard,193,92,University of Minnesota,1973,591,15807,2519,6083,937,1202,961,2515,1558,3568,352,1304,1656,1221,445,135,779,1251,6936
Wade Baldwin,193,91,Vanderbilt University,1996,33,405,36,115,31,37,3,22,33,93,11,35,46,61,18,7,40,40,106
Walker Russell,196,88,Western Michigan University,1960,99,1248,131,325,55,76,7,31,124,294,33,88,121,255,55,10,133,128,324
Wallace Bryant,213,111,University of San Francisco,1959,90,1296,97,244,52,82,0,0,97,244,108,239,347,114,31,34,64,186,246
Wally Szczerbiak,198,95,George Washington University,1949,798,24517,4290,8927,2060,2384,782,1926,3508,7001,782,2350,3132,1849,451,191,1182,1633,11422
Walt Williams,193,88,Indiana University,1923,840,22457,3547,8365,1724,2313,1170,3087,2377,5278,913,2400,3313,1989,802,499,1564,2445,9988
Walter Berry,203,97,St. John's University,1964,337,7804,1862,3494,766,1182,2,10,1860,3484,620,927,1547,474,189,239,646,965,4492
Walter Bond,196,90,University of Minnesota,1969,176,2717,368,889,188,247,56,178,312,711,88,233,321,201,103,38,163,407,980
Walter Davis,203,92,Texas A&M University,1931,578,14605,4054,8378,1492,1697,131,466,3923,7912,431,972,1403,1764,619,32,1076,1226,9731
Walter Herrmann,206,102,NaN,1979,197,2312,368,825,102,128,134,363,234,462,100,292,392,84,38,13,73,167,972
Walter McCarty,208,104,University of Kentucky,1974,665,11280,1187,3021,431,625,511,1473,676,1548,439,1253,1692,707,405,188,556,1355,3316
Walter Palmer,216,97,Dartmouth College,1968,48,209,42,102,16,24,0,1,42,101,18,47,65,11,4,9,16,49,100
Walter Sharpe,206,111,University of Alabama at Birmingham,1986,8,20,4,11,0,2,0,2,4,9,0,3,3,0,0,2,0,3,8
Walter Tavares,221,117,NaN,1992,11,73,11,19,3,8,0,0,11,19,7,14,21,3,1,6,5,8,25
Wang Zhizhi,213,115,NaN,1977,153,1370,230,557,117,157,74,196,156,361,60,189,249,41,28,40,74,168,651
Warren Kidd,206,106,Middle Tennessee State University,1970,68,884,100,169,47,86,0,0,100,169,76,157,233,19,19,23,44,129,247
Wayman Tisdale,206,108,University of Oklahoma,1964,919,26302,5870,11611,2519,3307,0,25,5870,11586,1804,3922,5726,1205,519,552,1579,3091,14259
Wayne Cooper,208,99,University of New Orleans,1956,532,10699,1629,3531,608,828,4,21,1625,3510,1101,2130,3231,430,160,1013,552,1711,3870
Wayne Ellington,193,90,University of North Carolina,1987,593,12043,1682,4064,424,494,695,1835,987,2229,200,1058,1258,664,296,37,403,637,4483
Wayne Englestad,203,111,"University of California, Irvine",1966,11,50,11,29,6,10,0,0,11,29,5,11,16,7,1,0,3,12,28
Wayne Sappleton,206,97,Loyola University of Chicago,1960,33,298,41,87,14,34,0,0,41,87,28,47,75,7,7,4,21,50,96
Wayne Selden,196,104,University of Kansas,1994,28,472,50,116,28,44,14,56,36,60,2,30,32,26,12,2,24,36,142
Wayne Simien,206,115,University of Kansas,1983,51,507,67,143,35,41,0,0,67,143,43,56,99,11,15,1,27,83,169
Wayne Turner,188,86,University of Kentucky,1976,3,41,1,6,2,6,0,0,1,6,1,2,3,5,0,0,3,4,4
Wes Matthews,185,77,University of Wisconsin,1959,255,4627,715,1427,317,399,14,75,701,1352,75,236,311,1073,208,51,476,419,1761
Wesley Johnson,201,97,Syracuse University,1987,497,11452,1434,3532,307,413,529,1570,905,1962,296,1340,1636,561,378,328,452,959,3704
Wesley Matthews,185,77,University of Wisconsin,1959,592,19357,2825,6577,1355,1637,1252,3265,1573,3312,323,1549,1872,1272,660,114,784,1315,8257
Wesley Person,198,88,Auburn University,1971,832,22431,3361,7383,826,1062,1246,2981,2115,4402,442,2160,2602,1339,617,243,735,1033,8794
Will Barton,198,79,University of Memphis,1991,372,7305,1203,2820,583,743,264,828,939,1992,221,1056,1277,662,258,121,436,484,3253
Will Blalock,183,92,Iowa State University,1983,14,166,9,30,6,6,1,5,8,25,6,9,15,17,5,0,12,9,25
Will Bynum,183,83,Georgia Institute of Technology,1983,360,6611,1117,2529,603,755,84,309,1033,2220,125,436,561,1185,256,29,578,670,2921
Will Cherry,183,83,University of Montana,1991,8,69,5,19,3,6,2,9,3,10,1,4,5,8,6,1,4,10,15
Will Conroy,188,88,University of Washington,1982,23,160,3,25,1,12,0,6,3,19,7,11,18,25,0,0,8,20,7
Will Perdue,213,108,Vanderbilt University,1965,792,12360,1517,2943,705,1222,1,15,1516,2928,1420,2498,3918,595,226,527,813,1589,3740
Will Solomon,185,83,Clemson University,1978,168,2296,323,821,99,141,102,334,221,487,36,160,196,358,89,15,170,218,847
William Avery,188,89,Duke University,1979,142,1205,137,415,65,91,40,157,97,258,17,76,93,199,34,6,106,125,379
William Bedford,213,102,University of Memphis,1963,238,2514,405,974,147,243,7,22,398,952,201,372,573,109,37,126,173,358,964
William Cunningham,211,113,Temple University,1974,46,402,14,54,0,4,0,0,14,54,34,42,76,4,6,22,10,80,28
Willie Anderson,201,86,University of Georgia,1967,631,18034,3092,6612,1196,1516,133,492,2959,6120,598,1730,2328,2302,669,401,1306,1730,7513
Willie Burton,203,95,University of Minnesota,1968,316,6666,1090,2569,923,1174,140,406,950,2163,326,606,932,393,191,121,517,846,3243
Willie Cauley-Stein,213,108,University of Kentucky,1993,141,2833,446,820,182,276,0,4,446,816,219,473,692,117,101,111,115,293,1074
Willie Green,193,90,University of Detroit Mercy,1981,731,14783,2417,5682,708,925,517,1494,1900,4188,242,1061,1303,1018,393,108,705,1259,6059
Willie Reed,206,106,Grambling State University,1942,110,1457,238,418,79,143,1,4,237,414,178,276,454,36,24,77,47,184,556
Willie Warren,193,92,University of Oklahoma,1989,19,134,13,35,6,8,5,15,8,20,1,11,12,27,6,0,8,16,37
Willie White,190,88,University of Tennessee at Chattanooga,1962,82,577,126,292,40,54,10,32,116,260,32,48,80,82,23,4,55,48,302
Willy Hernangomez,211,108,NaN,1994,72,1324,246,465,91,125,4,15,242,450,170,332,502,96,41,36,100,150,587
Wilson Chandler,203,102,DePaul University,1987,588,18431,3230,7248,1053,1362,802,2355,2428,4893,680,2543,3223,1045,435,436,863,1648,8315
Winston Bennett,201,95,University of Kentucky,1965,190,2990,337,815,169,243,0,2,337,813,240,336,576,158,69,30,148,427,843
Winston Crite,201,105,Texas A&M University,1965,31,264,34,71,19,25,0,0,34,71,28,37,65,15,5,8,26,43,87
Winston Garland,188,77,Missouri State University,1964,590,15153,2142,5017,1004,1209,85,296,2057,4721,464,1183,1647,2724,752,90,1133,1403,5373
World B.,206,97,NaN,1952,224,5751,1443,3234,803,1044,152,406,1291,2828,152,340,492,724,191,42,378,449,3841
Xavier Henry,198,99,University of Kansas,1991,185,2905,368,907,273,430,41,126,327,781,81,270,351,120,100,23,139,264,1050
Xavier McDaniel,201,92,Wichita State University,1963,951,27835,6263,12871,2379,3313,74,291,6189,12580,2255,3615,5870,1962,867,462,2071,2821,14979
Xavier Munford,196,90,NaN,1996,14,244,32,77,7,14,9,23,23,54,3,28,31,22,13,3,15,25,80
Xavier Silas,196,92,Northern Illinois University,1988,2,39,4,15,2,3,1,6,3,9,2,2,4,3,0,0,3,5,11
Yakhouba Diawara,201,102,Pepperdine University,1982,187,2614,233,653,67,103,122,405,111,248,77,181,258,122,52,16,72,276,655
Yao Ming*,229,140,NaN,1980,486,15818,3380,6445,2485,2984,2,10,3378,6435,1233,3261,4494,769,189,920,1311,1596,9247
Yaroslav Korolev,206,92,NaN,1987,34,168,13,46,10,16,3,12,10,34,6,10,16,13,6,0,7,11,39
Yi Jianlian,213,108,NaN,1987,272,6038,813,2012,447,573,75,225,738,1787,379,960,1339,192,136,184,302,618,2148
Yinka Dare,213,120,George Washington University,1972,110,1002,86,217,61,107,0,0,86,217,101,180,281,4,12,70,96,179,233
Yogi Ferrell,183,81,Indiana University,1993,92,2394,320,788,148,178,136,352,184,436,40,182,222,344,84,18,140,180,924
Yuta Tabuse,175,74,Brigham Young University Hawaii,1980,4,17,1,6,4,4,1,1,0,5,2,2,4,3,0,0,1,1,7
Yvon Joseph,211,111,Georgia Institute of Technology,1957,1,5,0,0,2,2,0,0,0,0,0,0,0,0,0,0,0,1,2
Zabian Dowdell,190,86,Virginia Polytechnic Institute and State Unive...,1984,24,292,51,125,16,17,3,10,48,115,5,15,20,51,20,2,29,30,121
Zach LaVine,196,85,"University of California, Los Angeles",1995,206,5945,1045,2346,427,520,300,793,745,1553,72,529,601,666,164,37,433,455,2817
Zach Randolph,206,117,Michigan State University,1981,1107,34865,7490,15884,3602,4729,180,679,7310,15205,3339,6976,10315,2025,835,307,2288,2643,18762
Zan Tabak,213,111,NaN,1970,304,4591,679,1366,182,364,0,4,679,1362,409,686,1095,213,85,164,330,740,1540
Zarko Cabarkapa,211,106,NaN,1981,190,2025,320,725,201,267,37,124,283,601,133,281,414,110,43,30,149,280,878
Zarko Paspalj,206,97,NaN,1966,28,181,27,79,18,22,0,1,27,78,15,15,30,10,3,7,21,37,72
Zaza Pachulia,211,122,NaN,1984,961,20390,2374,5102,2026,2710,0,26,2374,5076,2174,3555,5729,1233,699,344,1316,2465,6774
Zeljko Rebraca,213,116,NaN,1972,239,3553,522,1003,323,409,0,0,522,1003,219,527,746,94,62,171,220,564,1367
Zendon Hamilton,211,113,St. John's University,1975,146,1609,183,414,245,371,0,0,183,414,187,288,475,33,43,28,114,220,611
Zoran Dragic,196,90,NaN,1989,32,150,22,60,6,10,6,28,16,32,10,6,16,10,4,0,10,12,56
Zoran Planinic,201,88,NaN,1982,148,1584,197,486,130,192,37,128,160,358,47,151,198,165,58,7,120,237,561
Zydrunas Ilgauskas,221,107,NaN,1975,843,22965,4207,8842,2531,3243,31,100,4176,8742,2444,3747,6191,955,421,1327,1509,2776,10976
